AAL : American Airlines Group, Inc.
AAMC : Altisource Asset Management Corp
AAN : Aaron's,  Inc.
AAOI : Applied Optoelectronics, Inc.
AAON : AAON, Inc.
AAPL : Apple Inc. (AAPL)
AAP : Advance Auto Parts Inc
AAT : American Assets Trust, Inc.
AAWW : Atlas Air Worldwide Holdings
AA : Alcoa Inc.
ABAX : ABAXIS, Inc.
ABBV : AbbVie Inc.
ABCB : Ameris Bancorp
ABCO : The Advisory Board Company
ABC : AmerisourceBergen Corporation
ABG : Asbury Automotive Group Inc
ABMD : ABIOMED, Inc.
ABM : ABM Industries Incorporated
ABT : Abbott Laboratories
ACAD : ACADIA Pharmaceuticals Inc.
ACAS : American Capital, Ltd.
ACAT : Arctic Cat Inc.
ACCO : Acco Brands Corporation
ACC : American Campus Communities Inc
ACET : Aceto Corporation
ACE : Ace Limited
ACFN : Acorn Energy, Inc.
ACGL : Arch Capital Group Ltd.
ACHC : Acadia Healthcare Company, Inc.
ACHN : Achillion Pharmaceuticals, Inc.
ACIW : ACI Worldwide, Inc.
ACI : Arch Coal, Inc.
ACLS : Axcelis Technologies, Inc.
ACM : Aecom Technology Corporation
ACN : Accenture plc.
ACOR : Acorda Therapeutics, Inc.
ACRE : Ares Commercial Real Estate Corporation
ACRX : AcelRx Pharmaceuticals, Inc.
ACTG : Acacia Research Corporation
ACW : Accuride Corporation New
ACXM : Acxiom Corporation
ADBE : Adobe Systems Incorporated
ADC : Agree Realty Corporation
ADI : Analog Devices, Inc.
ADMS : Adamas Pharmaceuticals, Inc.
ADM : Archer-Daniels-Midland Company
ADP : Automatic Data Processing, Inc.
ADSK : Autodesk, Inc.
ADS : Alliance Data Systems Corporation
ADTN : ADTRAN, Inc.
ADT : ADT Corporation
ADUS : Addus HomeCare Corporation
AEC : Associated Estates Realty Corporation
AEE : Ameren Corporation
AEGN : Aegion Corp
AEGR : Aegerion Pharmaceuticals, Inc.
AEIS : Advanced Energy Industries, Inc.
AEL : American Equity Investment Life Holding Company
AEO : American Eagle Outfitters, Inc.
AEPI : AEP Industries Inc.
AEP : American Electric Power Company, Inc.
AERI : Aerie Pharmaceuticals, Inc.
AES : The AES Corporation
AET : Aetna Inc.
AE : Adams Resources & Energy, Inc.
AFAM : Almost Family Inc
AFFX : Affymetrix, Inc.
AFG : American Financial Group, Inc.
AFH : Atlas Financial Holdings, Inc.
AFL : Aflac Incorporated
AFOP : Alliance Fiber Optic Products, Inc.
AFSI : AmTrust Financial Services, Inc.
AF : Astoria Financial Corporation
AGCO : AGCO Corporation
AGEN : Agenus Inc.
AGII : Argo Group International Holdings, Ltd.
AGIO : Agios Pharmaceuticals, Inc.
AGM : Federal Agricultural Mortgage Corporation
AGNC : American Capital Agency Corp.
AGN : Allergen plc
AGO : Assured Guaranty Ltd.
AGTC : Applied Genetic Technologies Corporation
AGX : Argan, Inc.
AGYS : Agilysys, Inc.
AHC : A.H. Belo Corporation
AHH : Armada Hoffler Properties, Inc.
AHL : Aspen Insurance Holdings Limited
AHP : Ashford Hospitality Prime, Inc.
AHS : AMN Healthcare Services Inc
AHT : Ashford Hospitality Trust Inc
AIG : American International Group, Inc.
AIMC : Altra Industrial Motion Corp.
AINV : Apollo Investment Corporation
AIN : Albany International Corporation
AIQ : Alliance HealthCare Services, Inc.
AIRM : Air Methods Corporation
AIR : AAR Corp.
AIT : Applied Industrial Technologies, Inc.
AIV : Apartment Investment and Management Company
AIZ : Assurant, Inc.
AI : Arlington Asset Investment Corp
AJG : Arthur J. Gallagher & Co.
AKAM : Akamai Technologies, Inc.
AKAO : Achaogen, Inc.
AKBA : Akebia Therapeutics, Inc.
AKRX : Akorn, Inc.
AKR : Acadia Realty Trust
AKS : AK Steel Holding Corporation
ALB : Albemarle Corporation
ALCO : Alico, Inc.
ALDR : Alder BioPharmaceuticals, Inc.
ALEX : Alexander & Baldwin Holdings, Inc.
ALE : Allete, Inc.
ALGN : Align Technology, Inc.
ALGT : Allegiant Travel Company
ALG : Alamo Group, Inc.
ALIM : Alimera Sciences, Inc.
ALJ : Alon USA Energy, Inc.
ALKS : Alkermes plc
ALK : Alaska Air Group, Inc.
ALLE : Allegion plc
ALL : Allstate Corporation
ALNY : Alnylam Pharmaceuticals, Inc.
ALOG : Analogic Corporation
ALR : Alere Inc.
ALSN : Allison Transmission Holdings, Inc.
ALTR : Altera Corporation
ALXN : Alexion Pharmaceuticals, Inc.
ALX : Alexander's, Inc.
AL : Air Lease Corporation
AMAG : AMAG Pharmaceuticals, Inc.
AMAT : Applied Materials, Inc.
AMBA : Ambarella, Inc.
AMBC : Ambac Financial Group, Inc.
AMBR : Amber Road, Inc.
AMCC : Applied Micro Circuits Corporation
AMCX : AMC Networks Inc.
AMC : AMC Entertainment Holdings, Inc.
AMD : Advanced Micro Devices, Inc.
AMED : Amedisys Inc
AME : AMTEK, Inc.
AMGN : Amgen Inc.
AMG : Affiliated Managers Group, Inc.
AMKR : Amkor Technology, Inc.
AMNB : American National Bankshares, Inc.
AMPE : Ampio Pharmaceuticals, Inc.
AMP : AMERIPRISE FINANCIAL SERVICES, INC.
AMRC : Ameresco, Inc.
AMRI : Albany Molecular Research, Inc.
AMRS : Amyris, Inc.
AMSC : American Superconductor Corporation
AMSF : AMERISAFE, Inc.
AMSG : Amsurg Corp.
AMSWA : American Software, Inc.
AMTD : TD Ameritrade Holding Corporation
AMTG : Apollo Residential Mortgage, Inc.
AMT : American Tower Corporation
AMWD : American Woodmark Corporation
AMZN : Amazon.com, Inc.
ANAC : Anacor Pharmaceuticals, Inc.
ANAD : ANADIGICS, Inc.
ANAT : American National Insurance Company
ANCX : Access National Corporation
ANDE : The Andersons, Inc.
ANF : Abercrombie & Fitch Company
ANGI : Angie's List, Inc.
ANGO : AngioDynamics, Inc.
ANH : Anworth Mortgage Asset  Corporation
ANIK : Anika Therapeutics Inc.
ANIP : ANI Pharmaceuticals, Inc.
ANN : ANN INC.
ANR : Alpha Natural Resources, inc.
ANSS : ANSYS, Inc.
ANTM : Untitled Dataset 2014-12-09 22:16:10
AN : AutoNation, Inc.
AOI : Alliance One International, Inc.
AON : Aon plc
AOSL : Alpha and Omega Semiconductor Limited
AOS : Smith
APAM : Artisan Partners Asset Management Inc.
APA : Apache Corporation
APC : Anadarko Petroleum Corporation
APD : Air Products and Chemicals, Inc.
APEI : American Public Education, Inc.
APH : Amphenol Corporation
APOG : Apogee Enterprises, Inc.
APOL : Apollo Education Group, Inc.
APP : American Apparel Inc
AP : Ampco-Pittsburgh Corporation
ARAY : Accuray Incorporated
ARCB : ArcBest Corporation
ARCC : Ares Capital Corporation
ARCW : ARC Group Worldwide, Inc.
ARC : ARC Document Solutions, Inc.
AREX : Approach Resources Inc.
ARE : Alexandria Real Estate Equities, Inc.
ARG : Airgas, Inc.
ARIA : ARIAD Pharmaceuticals, Inc.
ARII : American Railcar Industries, Inc.
ARI : Apollo Commercial Real Estate Finance
ARNA : Arena Pharmaceuticals, Inc.
AROW : Arrow Financial Corporation
ARO : Aeropostale Inc
ARPI : American Residential Properties, Inc.
ARQL : ArQule, Inc.
ARRS : ARRIS Group, Inc.
ARRY : Array BioPharma Inc.
ARR : ARMOUR Residential REIT, Inc.
ARTNA : Artesian Resources Corporation
ARWR : Arrowhead Research Corporation
ARW : Arrow Electronics, Inc.
ASCMA : Ascent Capital Group, Inc.
ASC : Ardmore Shipping Corporation
ASEI : American Science and Engineering, Inc.
ASGN : On Assignment, Inc.
ASH : Ashland Inc.
ASNA : Ascena Retail Group, Inc.
ASPS : Altisource Portfolio Solutions S.A.
ASTE : Astec Industries, Inc.
ATEC : Alphatec Holdings, Inc.
ATEN : Untitled Dataset 2014-07-28 20:51:48
ATHN : athenahealth, Inc.
ATLO : Ames National Corporation
ATML : Atmel Corporation
ATNI : Atlantic Tele-Network, Inc.
ATNM : Cactus Ventures, Inc.
ATNY : API Technologies Corp.
ATO : Atmos Energy Corporation
ATRC : AtriCure, Inc.
ATRI : ATRION Corporation
ATRO : Astronics Corporation
ATRS : Antares Pharma, Inc.
ATR : AptarGroup, Inc.
ATSG : Air Transport Services Group, Inc
ATU : Actuant Corporation
ATVI : Activision Blizzard, Inc
ATW : Atwood Oceanics, Inc.
AT : Atlantic Power Corporation
AVAV : AeroVironment, Inc.
AVA : Avista Corporation
AVB : AvalonBay Communities, Inc.
AVD : American Vanguard Corporation
AVEO : AVEO Pharmaceuticals, Inc.
AVGO : Avago Technologies Limited
AVG : AVG Technologies N.V.
AVHI : A V Homes, Inc.
AVID : Avid Technology, Inc.
AVNW : Aviat Networks, Inc.
AVT : Avnet, Inc.
AVX : AVX Corporation
AVY : Avery Dennison Corporation
AWAY : HomeAway, Inc.
AWH : Allied World Assurance Company Holdings, AG
AWI : Armstrong World Industries Inc
AWK : American Water Works
AWR : American States Water Company
AXAS : Abraxas Petroleum Corporation
AXDX : Accelerate Diagnostics, Inc.
AXE : Anixter International Inc.
AXLL : Axiall Corporation
AXL : American Axle & Manufacturing Holdings, Inc.
AXP : American Express Company
AXS : Axis Capital Holdings Limited
AYI : Acuity Brands Inc
AYR : Aircastle Limited
AZO : AutoZone, Inc.
AZPN : Aspen Technology, Inc.
AZZ : AZZ Incorporated
A : Agilent Technologies, Inc.
BABY : Natus Medical Incorporated
BAC : Bank of America Corporation
BAGR : Diversified Restaurant Holdings, Inc.
BAH : Booz Allen Hamilton Holding Corporation
BALT : Baltic Trading Limited
BANC : Banc of California, Inc.
BANF : BancFirst Corporation
BANR : Banner Corporation
BAS : Basic Energy Services, Inc.
BAX : Baxter International Inc.
BA : Boeing Company
BBBY : Bed Bath & Beyond Inc.
BBCN : BBCN Bancorp, Inc.
BBGI : Beasley Broadcast Group, Inc.
BBG : Bill Barrett Corporation
BBOX : Black Box Corporation
BBRG : Bravo Brio Restaurant Group, Inc.
BBSI : Barrett Business Services, Inc.
BBT : BB&T Corporation
BBW : Build-A-Bear Workshop, Inc.
BBX : BBX Capital Corporation
BBY : Best Buy Co., Inc.
BCC : Boise Cascade, L.L.C.
BCEI : Bonanza Creek Energy, Inc.
BCOR : Blucora, Inc.
BCOV : Brightcove Inc.
BCO : Brink's Company
BCPC : Balchem Corporation
BCRX : BioCryst Pharmaceuticals, Inc.
BCR : C.R. Bard, Inc.
BC : Brunswick Corporation
BDBD : Boulder Brands, Inc.
BDC : Belden Inc
BDE : Black Diamond, Inc.
BDGE : Bridge Bancorp, Inc.
BDN : Brandywine Realty Trust
BDSI : BioDelivery Sciences International, Inc.
BDX : Becton, Dickinson and Company
BEAT : BioTelemetry, Inc.
BEAV : B/E Aerospace, Inc.
BEBE : bebe stores, inc.
BECN : Beacon Roofing Supply, Inc.
BEE : Strategic Hotels & Resorts Inc
BELFB : Bel Fuse Inc.
BEN : Franklin Resources, Inc.
BERY : BPC Acquisition Corp
BF_B : Brown Forman Corporation
BFAM : Bright Horizons Family Solutions Inc.
BFIN : BankFinancial Corporation
BFS : Saul Centers, Inc.
BGCP : BGC Partners, Inc.
BGC : General Cable Corporation
BGFV : Big 5 Sporting Goods Corporation
BGG : Briggs & Stratton Corporation
BGS : B&G Foods, Inc.
BG : Bunge Limited
BHB : Bar Harbor Bankshares, Inc.
BHE : Benchmark Electronics, Inc.
BHI : Baker Hughes Incorporated
BHLB : Berkshire Hills Bancorp, Inc.
BH : Biglari Holdings Inc.
BIDU : Baidu, Inc.
BID : Sotheby's
BIG : Big Lots, Inc.
BIIB : Biogen Idec Inc.
BIOL : Biolase, Inc.
BIOS : BioScrip, Inc.
BIO : Bio-Rad Laboratories, Inc.
BJRI : BJ's Restaurants, Inc.
BKCC : BlackRock Kelso Capital Corporation
BKD : Brookdale Senior Living Inc.
BKE : Buckle, Inc.
BKH : Black Hills Corporation
BKMU : Bank Mutual Corporation
BKS : Barnes & Noble, Inc.
BKU : BankUnited, Inc.
BK : Bank Of New York Mellon Corporation
BLDR : Builders FirstSource, Inc.
BLKB : Blackbaud, Inc.
BLK : BlackRock, Inc.
BLL : Ball Corporation
BLMN : Bloomin' Brands, Inc.
BLOX : Infoblox Inc.
BLT : Blount International, Inc.
BLUE : bluebird bio, Inc.
BLX : Banco Latinoamericano de Comercio Exterior, S.A.
BMI : Badger Meter, Inc.
BMRC : Bank of Marin Bancorp
BMRN : BioMarin Pharmaceutical Inc.
BMR : (BMR) Prices, Dividends, Splits and Trading Volume
BMS : Bemis Company, Inc.
BMTC : Bryn Mawr Bank Corporation
BMY : Bristol-Myers Squibb Company
BNCL : Beneficial Mutual Bancorp, Inc.
BNCN : BNC Bancorp
BNFT : Benefitfocus, Inc.
BOBE : Bob Evans Farms, Inc.
BOFI : BofI Holding, Inc.
BOH : Bank of Hawaii Corporation
BOKF : BOK Financial Corporation
BONT : The Bon-Ton Stores, Inc.
BOOM : Dynamic Materials Corporation
BPFH : Boston Private Financial Holdings, Inc.
BPI : Bridgepoint Education, Inc.
BPOP : Popular, Inc.
BPTH : Bio-Path Holdings Inc
BP : BP p.l.c.
BRCD : Brocade Communications Systems, Inc.
BRCM : Broadcom Corporation
BRC : Brady Corporation
BREW : Craft Brew Alliance, Inc.
BRK_A : Berkshire Hathaway Inc.
BRKL : Brookline Bancorp, Inc.
BRKR : Bruker Corporation
BRKS : Brooks Automation, Inc.
BRLI : Bio-Reference Laboratories, Inc.
BRO : Brown & Brown, Inc.
BRSS : Global Brass and Copper Holdings, Inc.
BRS : Bristow Group Inc
BRT : (BRT) Prices, Dividends, Splits and Trading Volume
BR : Broadridge Financial Solutions, Inc.
BSET : Bassett Furniture Industries, Incorporated
BSFT : BroadSoft, Inc.
BSRR : Sierra Bancorp
BSTC : BioSpecifics Technologies Corp
BSX : Boston Scientific Corporation
BTH : Blyth, Inc.
BTU : Peabody Energy Corporation
BTX : BioTime, Inc.
BURL : Burlington Stores, Inc.
BUSE : First Busey Corporation
BV : Bazaarvoice, Inc.
BWA : BorgWarner Inc.
BWINB : Baldwin & Lyons, Inc.
BWLD : Buffalo Wild Wings, Inc.
BXC : BlueLinx Holdings Inc.
BXLT : Untitled Dataset 2015-07-01 21:45:47
BXP : Boston Properties, Inc.
BXS : BancorpSouth, Inc.
BYD : Boyd Gaming Corporation
BZH : Beazer Homes USA, Inc.
B : Barnes Group, Inc.
CAB : Cabela's Inc
CACB : Cascade Bancorp
CACC : Credit Acceptance Corporation
CACI : CACI International, Inc.
CACQ : Caesars Acquisition Company
CAC : Camden National Corporation
CAG : ConAgra Foods, Inc.
CAH : Cardinal Health, Inc.
CAKE : The Cheesecake Factory Incorporated
CALD : Callidus Software, Inc.
CALL : magicJack VocalTec Ltd
CALM : Cal-Maine Foods, Inc.
CALX : Calix, Inc
CAMP : CalAmp Corp.
CAM : Cameron International Corporation
CAP : Cai International, Inc.
CARA : Cara Therapeutics, Inc.
CARB : Carbonite, Inc.
CAR : Avis Budget Group, Inc.
CASH : Meta Financial Group, Inc.
CASS : Cass Information Systems, Inc
CASY : Caseys General Stores, Inc.
CAS : Castle
CATM : Cardtronics, Inc.
CATO : Cato Corporation
CATY : Cathay General Bancorp
CAT : Caterpillar, Inc.
CAVM : Cavium, Inc.
CA : CA Inc.
CBB : Cincinnati Bell Inc
CBF : Capital Bank Financial Corp.
CBG : CBRE Group, Inc.
CBI : Chicago Bridge & Iron Company N.V.
CBK : Christopher & Banks Corporation
CBL : CBL & Associates Properties, Inc.
CBM : Cambrex Corporation
CBOE : CBOE Holdings, Inc.
CBPX : Continental Building Products, Inc.
CBRL : Cracker Barrel Old Country Store, Inc.
CBR : Ciber, Inc.
CBSH : Commerce Bancshares, Inc.
CBS : CBS Corporation
CBT : Cabot Corporation
CBU : Community Bank System, Inc.
CBZ : CBIZ, Inc.
CB : Chubb Corporation
CCBG : Capital City Bank Group
CCC : Calgon Carbon Corporation
CCE : Coca-Cola Enterprises, Inc.
CCF : Chase Corporation
CCG : Campus Crest Communities, Inc.
CCI : Crown Castle International Corporation
CCK : Crown Holdings, Inc.
CCL : Carnival Corporation
CCMP : Cabot Microelectronics Corporation
CCNE : CNB Financial Corporation
CCOI : Cogent Communications Holdings, Inc.
CCO : Clear Channel Outdoor Holdings, Inc.
CCRN : Cross Country Healthcare, Inc.
CCXI : ChemoCentryx, Inc.
CDE : Coeur Mining, Inc.
CDI : CDI Corporation
CDNS : Cadence Design Systems, Inc.
CDR : Cedar Realty Trust, Inc.
CEB : The Corporate Executive Board Company
CECE : CECO Environmental Corp.
CECO : Career Education Corporation
CELG : Celgene Corporation
CEMP : Cempra, Inc.
CENTA : Central Garden & Pet Company
CENX : Century Aluminum Company
CERN : Cerner Corporation
CERS : Cerus Corporation
CETV : Central European Media Enterprises Ltd.
CEVA : CEVA, Inc.
CE : Celanese Corporation
CFFI : C&F Financial Corporation
CFFN : Capitol Federal Financial, Inc.
CFI : Culp, Inc.
CFNB : California First National Bancorp
CFNL : Cardinal Financial Corporation
CFR : Cullen/Frost Bankers, Inc.
CFX : Colfax Corporation
CF : CF Industries Holdings, Inc.
CGI : Celadon Group, Inc.
CGNX : Cognex Corporation
CHCO : City Holding Company
CHDN : Churchill Downs, Incorporated
CHD : Church & Dwight Company, Inc.
CHEF : The Chefs' Warehouse, Inc.
CHE : Chemed Corp.
CHFC : Chemical Financial Corporation
CHFN : Charter Financial Corp.
CHGG : Chegg, Inc.
CHH : Choice Hotels International, Inc.
CHKP : Check Point Software Technologies Ltd.
CHK : Chesapeake Energy Corporation
CHMG : Chemung Financial Corp
CHMT : Chemtura Corp.
CHRW : C.H. Robinson Worldwide, Inc.
CHSP : Chesapeake Lodging Trust
CHS : Chico's FAS, Inc.
CHTR : Charter Communications, Inc.
CHUY : Chuy's Holdings, Inc.
CIA : Citizens, Inc.
CIDM : Cinedigm Corp
CIEN : Ciena Corporation
CIE : Cobalt International Energy, Inc.
CIFC : CIFC Corp.
CIM : Chimera Investment Corporation
CINF : Cincinnati Financial Corporation
CIR : CIRCOR International, Inc.
CIT : CIT Group Inc
CIX : CompX International Inc.
CI : Cigna Corporation
CJES : C&J Energy Services, Inc.
CKEC : Carmike Cinemas, Inc.
CKH : SEACOR Holdings, Inc.
CKP : Checkpoint Systms, Inc.
CLCT : Collectors Universe, Inc.
CLC : CLARCOR Inc.
CLDT : Chatham Lodging Trust
CLDX : Celldex Therapeutics, Inc.
CLD : Cloud Peak Energy Inc
CLFD : Clearfield, Inc.
CLF : Cliffs Natural Resources Inc.
CLGX : CoreLogic, Inc.
CLH : Clean Harbors, Inc.
CLI : Mack-Cali Realty Corporation
CLMS : Calamos Asset Management, Inc.
CLNE : Clean Energy Fuels Corp.
CLNY : Colony Financial, Inc
CLR : Continental Resources, Inc.
CLUB : Town Sports International Holdings, Inc.
CLVS : Clovis Oncology, Inc.
CLW : Clearwater Paper Corporation
CLX : Clorox Company
CL : Colgate-Palmolive Company
CMA : Comerica Incorporated
CMCO : Columbus McKinnon Corporation
CMCSA : Comcast Corporation
CMC : Commercial Metals Company
CME : CME Group Inc.
CMG : Chipotle Mexican Grill, Inc.
CMI : Cummins Inc.
CMLS : Cumulus Media Inc.
CMN : Cantel Medical Corp.
CMO : Capstead Mortgage Corporation
CMP : Compass Minerals International, Inc.
CMRX : Chimerix, Inc.
CMS : CMS Energy Corporation
CMTL : Comtech Telecommunications Corp.
CNA : CNA Financial Corporation
CNBKA : Century Bancorp, Inc.
CNC : Centene Corporation
CNK : Cinemark Holdings Inc
CNL : Cleco Corporation
CNMD : CONMED Corporation
CNOB : ConnectOne Bancorp, Inc.
CNO : CNO Financial Group, Inc.
CNP : CenterPoint Energy, Inc.
CNSI : Comverse Inc.
CNSL : Consolidated Communications Holdings, Inc.
CNS : Cohn & Steers Inc
CNW : Con-way Inc.
CNX : CONSOL Energy Inc.
COBZ : CoBiz Financial Inc.
COB : CommunityOne Bancorp
COF : Capital One Financial Corporation
COG : Cabot Oil & Gas Corporation
COHR : Coherent, Inc.
COHU : Cohu, Inc.
COH : Coach, Inc.
COKE : Coca-Cola Bottling Co. Consolidated
COLB : Columbia Banking System, Inc.
COLM : Columbia Sportswear Company
COL : Rockwell Collins, Inc.
CONE : CyrusOne Inc
CONN : Conn's, Inc.
COO : Cooper Companies, Inc.
COP : ConocoPhillips
CORE : Core-Mark Holding Company, Inc.
CORR : CorEnergy Infrastructure Trust, Inc.
CORT : Corcept Therapeutics Incorporated
COR : CoreSite Realty Corporation
COST : Costco Wholesale Corporation
COUP : Coupons.com Incorporated
COVS : Covisint Corporation
COWN : Cowen Group, Inc.
CPA : Copa Holdings, S.A.
CPB : Campbell Soup Company
CPE : Callon Petroleum Company
CPF : CPB Inc.
CPGX : Untitled Dataset 2015-07-02 21:46:08
CPHD : CEPHEID
CPK : Chesapeake Utilities Corporation
CPLA : Capella Education Company
CPN : Calpine Corporation
CPRT : Copart, Inc.
CPSI : Computer Programs and Systems, Inc.
CPSS : Consumer Portfolio Services, Inc.
CPST : Capstone Turbine Corporation
CPS : Cooper-Standard Holdings Inc.
CPT : Camden Property Trust
CRAI : CRA International,Inc.
CRAY : Cray Inc
CRCM : Care.com, Inc.
CRD_B : Crawford & Company
CREE : Cree, Inc.
CRIS : Curis, Inc.
CRI : Carter's, Inc.
CRK : Comstock Resources, Inc.
CRL : Charles River Laboratories International, Inc.
CRMT : America's Car-Mart, Inc.
CRM : Salesforce.com Inc
CROX : Crocs, Inc.
CRR : Carbo Ceramics, Inc.
CRS : Carpenter Technology Corporation
CRUS : Cirrus Logic, Inc.
CRVL : CorVel Corp.
CRWN : Crown Media Holdings, Inc.
CRY : CryoLife, Inc.
CRZO : Carrizo Oil & Gas, Inc.
CR : Crane Company
CSBK : Clifton Bancorp Inc.
CSCD : Cascade Microtech, Inc.
CSCO : Cisco Systems, Inc.
CSC : Computer Sciences Corporation
CSFL : CenterState Banks, Inc.
CSGP : CoStar Group, Inc.
CSGS : CSG Systems International, Inc.
CSG : Chambers Street Properties
CSH : Cash America International, Inc.
CSII : Cardiovascular Systems, Inc.
CSLT : Castlight Health, inc.
CSL : Carlisle Companies Incorporated
CSOD : Cornerstone OnDemand, Inc.
CSS : CSS Industries, Inc.
CST : CST Brands, Inc.
CSU : Capital Senior Living Corporation
CSV : Carriage Services, Inc.
CSWC : Capital Southwest Corporation
CSX : CSX Corporation
CTAS : Cintas Corporation
CTBI : Community Trust Bancorp, Inc.
CTB : Cooper Tire & Rubber Company
CTCT : Constant Contact, Inc.
CTG : Computer Task Group, Incorporated
CTIC : Cell Therapeutics, Inc.
CTL : CenturyLink, Inc.
CTO : Consolidated-Tomoka Land Co.
CTRE : CareTrust REIT, Inc.
CTRL : Control4 Corporation
CTRN : Citi Trends, Inc.
CTRX : Catamaran Corporation
CTSH : Cognizant Technology Solutions Corporation
CTS : CTS Corporation
CTT : CatchMark Timber Trust, Inc.
CTWS : Connecticut Water Service, Inc.
CTXS : Citrix Systems, Inc.
CUBE : CubeSmart
CUBI : Customers Bancorp, Inc
CUB : Cubic Corporation
CUDA : Barracuda Networks, Inc.
CUI : CUI Global, Inc.
CUNB : CU Bancorp
CUR : (CUR) Prices, Dividends, Splits and Trading Volume
CUTR : Cutera, Inc.
CUZ : Cousins Properties Incorporated
CVA : Covanta Holding Corporation
CVBF : CVB Financial Corporation
CVCO : Cavco Industries, Inc.
CVC : Cablevision Systems Corporation
CVEO : Civeo Corporation
CVGI : Commercial Vehicle Group, Inc.
CVGW : Calavo Growers, Inc.
CVG : Convergys Corporation
CVI : CVR Energy Inc.
CVLT : CommVault Systems, Inc.
CVO : Cenveo Inc
CVS : CVS Corporation
CVT : CVENT, INC.
CVX : Chevron Corporation
CWCO : Consolidated Water Co. Ltd.
CWEI : Clayton Williams Energy, Inc.
CWST : Casella Waste Systems, Inc.
CWT : California Water  Service Group Holding
CW : Curtiss-Wright Corporation
CXO : Concho Resources Inc.
CXW : Corrections Corporation of America
CYBX : Cyberonics, Inc.
CYH : Community Health Systems, Inc.
CYNI : Cyan, Inc.
CYNO : Cynosure, Inc.
CYN : City National Corporation
CYS : CYS Investments, Inc.
CYTK : Cytokinetics, Incorporated
CYTR : CytRx Corporation
CYTX : Cytori Therapeutics Inc
CYT : Cytec Industries Inc.
CY : Cypress Semiconductor Corporation
CZNC : Citizens & Northern Corp
CZR : Caesars Entertainment Corporation
C : Citigroup Inc.
DAKT : Daktronics, Inc.
DAL : Delta Air Lines, Inc.
DAN : Dana Holding Corporation
DAR : Darling Ingredients Inc.
DATA : Tableau Software, Inc.
DAVE : Famous Dave's of America, Inc.
DBD : Diebold, Incorporated
DCI : Donaldson Company, Inc.
DCOM : Dime Community Bancshares, Inc.
DCO : Ducommun Incorporated
DCT : DCT Industrial Trust Inc
DDD : 3D Systems Corporation
DDR : DDR Corp.
DDS : Dillard's, Inc.
DD : E.I. du Pont de Nemours and Company
DECK : Deckers Outdoor Corporation
DEI : Douglas Emmett, Inc.
DEL : Deltic Timber Corporation
DENN : Denny's Corporation
DEPO : Depomed, Inc.
DEST : Destination Maternity Corporation
DE : Deere & Company
DFRG : Del Frisco's Restaurant Group, Inc.
DFS : Discover Financial Services
DFT : Dupont Fabros Technology, Inc.
DF : Dean Foods Company
DGAS : Delta Natural Gas Company, Inc.
DGICA : Donegal Group, Inc.
DGII : Digi International Inc.
DGI : DigitalGlobe, Inc
DGX : Quest Diagnostics Incorporated
DG : Dollar General Corporation
DHIL : Diamond Hill Investment Group, Inc.
DHI : D.R. Horton, Inc.
DHR : Danaher Corporation
DHT : DHT Holdings, Inc.
DHX : Dice Holdings, Inc.
DIN : DineEquity, Inc
DIOD : Diodes Incorporated
DISCA : Discovery Communications, Inc.
DISCK : Discovery Communications, Inc.
DISH : DISH Network Corporation
DIS : Walt Disney Company
DJCO : Daily Journal Corp.
DKS : Dick's Sporting Goods Inc
DK : Delek US Holdings, Inc.
DLB : Dolby Laboratories
DLPH : Delphi Automotive plc
DLR : Digital Realty Trust, Inc.
DLTR : Dollar Tree, Inc.
DLX : Deluxe Corporation
DMD : Demand Media Inc.
DMND : Diamond Foods, Inc.
DMRC : Digimarc Corporation
DNB : Dun & Bradstreet Corporation
DNKN : Dunkin' Brands Group, Inc.
DNR : Denbury Resources Inc.
DOC : Physicians Realty Trust
DOOR : (DOOR) Prices, Dividends, Splits and Trading Volume
DORM : Dorman Products, Inc.
DOV : Dover Corporation
DOW : Dow Chemical Company
DOX : Amdocs Limited
DO : Diamond Offshore Drilling, Inc.
DPS : Dr Pepper Snapple Group, Inc
DPZ : Domino's Pizza Inc
DRE : Duke Realty Corporation
DRH : Diamondrock Hospitality Company
DRII : Diamond Resorts International, Inc.
DRI : Darden Restaurants, Inc.
DRNA : Dicerna Pharmaceuticals, Inc.
DRQ : Dril-Quip, Inc.
DSCI : Derma Sciences, Inc.
DSPG : DSP Group, Inc.
DST : DST Systems, Inc.
DSW : DSW Inc.
DTE : DTE Energy Company
DTLK : Datalink Corporation
DTSI : DTS, Inc.
DTV : DIRECTV
DUK : Duke Energy Corporation
DVAX : Dynavax Technologies Corporation
DVA : DaVita healthCare Partners Inc.
DVN : Devon Energy Corporation
DV : DeVry Education Group Inc.
DWA : Dreamworks Animation SKG, Inc.
DWRE : DEMANDWARE, INC.
DWSN : Dawson Geophysical Company
DW : Drew Industries Incorporated
DXCM : DexCom, Inc.
DXLG : Destination XL Group, Inc.
DXM : Dex Media, Inc.
DXPE : DXP Enterprises, Inc.
DXYN : The Dixie Group, Inc.
DX : Dynex Capital, Inc.
DYAX : Dyax Corp.
DYN : Dynegy Inc.
DY : Dycom Industries, Inc.
D : Dominion Resources, Inc.
EAC : Erickson Incorporated
EAT : Brinker International, Inc.
EA : Electronic Arts Inc.
EBAY : eBay Inc.
EBF : Ennis, Inc.
EBIO : Eleven Biotherapeutics, Inc.
EBIX : Ebix, Inc.
EBSB : Meridian Interstate Bancorp, Inc.
EBS : Emergent Biosolutions, Inc.
EBTC : Enterprise Bancorp Inc
ECHO : Echo Global Logistics, Inc.
ECL : Ecolab Inc.
ECOL : US Ecology, Inc.
ECOM : ChannelAdvisor Corporation
ECPG : Encore Capital Group Inc
ECYT : Endocyte, Inc.
EDE : Empire District Electric Company
EDR : Education Realty Trust Inc.
ED : Consolidated Edison Inc
EEFT : Euronet Worldwide, Inc.
EE : El Paso Electric Company
EFII : Electronics for Imaging, Inc.
EFSC : Enterprise Financial Services Corporation
EFX : Equifax, Inc.
EGAN : eGain Corporation
EGBN : Eagle Bancorp, Inc.
EGHT : 8x8 Inc
EGLT : Egalet Corporation
EGL : Engility Holdings, Inc.
EGN : Energen Corporation
EGOV : NIC Inc.
EGP : EastGroup Properties, Inc.
EGY : Vaalco Energy Inc
EHTH : eHealth, Inc.
EIGI : Endurance International Group Holdings, Inc.
EIG : Employers Holdings Inc
EIX : Edison International
ELGX : Endologix, Inc.
ELLI : Ellie Mae, Inc.
ELNK : EarthLink Holdings Corp.
ELRC : Electro Rent Corporation
ELS : Equity Lifestyle Properties, Inc.
ELY : Callaway Golf Company
EL : Estee Lauder Companies, Inc.
EMCI : EMC Insurance Group Inc.
EMC : EMC Corporation
EME : EMCOR Group, Inc.
EMN : Eastman Chemical Company
EMR : Emerson Electric Company
ENDP : Endo International plc
ENH : Endurance Specialty Holdings Ltd
ENOC : EnerNOC, Inc.
ENPH : Enphase Energy, Inc.
ENR : Energizer Holdings, Inc.
ENSG : The Ensign Group, Inc.
ENS : Enersys
ENTA : Enanta Pharmaceuticals, Inc.
ENTG : Entegris, Inc.
ENT : Global Eagle Entertainment Inc.
ENV : Envestnet, Inc
ENZN : Enzon Pharmaceuticals, Inc.
ENZ : Enzo Biochem, Inc.
EOG : EOG Resources, Inc.
EOX : Emerald Oil, Inc.
EPAM : EPAM Systems, Inc.
EPAY : Bottomline Technologies, Inc.
EPIQ : EPIQ Systems, Inc.
EPM : Evolution Petroleum Corporation, Inc.
EPR : EPR Properties
EPZM : Epizyme, Inc.
EQIX : Equinix, Inc.
EQR : Equity Residential
EQT : EQT Corporation
EQY : Equity One, Inc.
ERA : Era Group, Inc.
ERIE : Erie Indemnity Company
ERII : Energy Recovery, Inc.
EROS : Eros International PLC
ESCA : Escalade, Incorporated
ESE : ESCO Technologies Inc.
ESGR : Enstar Group Limited
ESIO : Electro Scientific Industries, Inc.
ESI : ITT Educational Services, Inc.
ESL : Esterline Technologies Corporation
ESNT : Essent Group Ltd.
ESPR : Esperion Therapeutics, Inc.
ESRT : Empire State Realty Trust, Inc.
ESRX : Express Scripts Holding Company
ESSA : ESSA Bancorp, Inc.
ESS : Essex Property Trust, Inc.
ESV : ENSCO plc
ES : Untitled Dataset 2015-02-20 22:03:57
ETFC : E*TRADE Financial Corporation
ETH : Ethan Allen Interiors Inc.
ETM : Entercom Communications Corporation
ETN : Eaton Corporation, PLC
ETR : Entergy Corporation
EVC : Entravision Communications Corporation
EVDY : Everyday Health, Inc.
EVER : EverBank Financial Corp.
EVR : Evercore Partners Inc
EVTC : Evertec, Inc.
EV : Eaton Vance Corporation
EWBC : East West Bancorp, Inc.
EW : Edwards Lifesciences Corporation
EXAC : Exactech, Inc.
EXAM : ExamWorks Group, Inc.
EXAR : Exar Corporation
EXAS : EXACT Sciences Corporation
EXC : Exelon Corporation
EXEL : Exelixis, Inc.
EXH : Exterran Holdings, Inc.
EXLS : ExlService Holdings, Inc.
EXL : Excel Trust, Inc.
EXPD : Expeditors International of Washington, Inc.
EXPE : Expedia, Inc.
EXPO : Exponent, Inc.
EXPR : Express, Inc.
EXP : Eagle Materials Inc
EXR : Extra Space Storage Inc
EXTR : Extreme Networks, Inc.
EXXI : Energy XXI
EZPW : EZCORP, Inc.
FAF : First American Corporation
FANG : Diamondback Energy, Inc.
FARM : Farmer Brothers Company
FARO : FARO Technologies, Inc.
FAST : Fastenal Company
FBC : Flagstar Bancorp, Inc.
FBHS : Fortune Brands Home & Security, Inc.
FBIZ : First Business Financial Services, Inc.
FBNC : First Bancorp
FBNK : First Connecticut Bancorp, Inc.
FBP : First BanCorp.
FBRC : FBR & Co
FB : Facebook, Inc.
FCBC : First Community Bancshares, Inc.
FCE_A : Forest City Enterprises Inc
FCEL : FuelCell Energy, Inc.
FCFS : First Cash Financial Services, Inc.
FCF : First Commonwealth Financial Corporation
FCH : FelCor Lodging Trust Incorporated
FCNCA : First Citizens BancShares, Inc.
FCN : FTI Consulting, Inc.
FCSC : Fibrocell Science Inc
FCS : Fairchild Semiconductor International, Inc.
FCX : Freeport-McMoran, Inc.
FC : Franklin Covey Company
FDEF : First Defiance Financial Corp.
FDML : Federal-Mogul Holdings Corporation
FDP : Fresh Del Monte Produce, Inc.
FDS : FactSet Research Systems Inc.
FDUS : Fidus Investment Corporation
FDX : FedEx Corporation
FEIC : FEI Company
FELE : Franklin Electric Co., Inc.
FET : Forum Energy Technologies, Inc.
FE : FirstEnergy Corporation
FFBC : First Financial Bancorp.
FFG : FBL Financial Group, Inc.
FFIC : Flushing Financial Corporation
FFIN : First Financial Bankshares, Inc.
FFIV : F5 Networks, Inc.
FFKT : Farmers Capital Bank Corporation
FFNW : First Financial Northwest, Inc.
FF : FutureFuel Corp.
FGL : Fidelity and Guaranty Life
FHCO : Female Health Company
FHN : First Horizon National Corporation
FIBK : First Interstate BancSystem, Inc.
FICO : Fair Isaac Corporation
FII : Federated Investors, Inc.
FINL : The Finish Line, Inc.
FISI : Financial Institutions, Inc.
FISV : Fiserv, Inc.
FIS : Fidelity National Information Services, Inc.
FITB : Fifth Third Bancorp
FIVE : Five Below, Inc.
FIVN : Five9, Inc.
FIX : Comfort Systems USA, Inc.
FIZZ : National Beverage Corp.
FLDM : Fluidigm Corporation
FLIC : The First of Long Island Corporation
FLIR : FLIR Systems, Inc.
FLO : Flowers Foods, Inc.
FLR : Fluor Corporation
FLS : Flowserve Corporation
FLTX : Fleetmatics Group PLC
FLT : FleetCor Technologies, Inc.
FLWS : 1-800 FLOWERS.COM, Inc.
FLXN : Flexion Therapeutics, Inc.
FLXS : Flexsteel Industries, Inc.
FL : Foot Locker, Inc.
FMBI : First Midwest Bancorp, Inc.
FMC : FMC Corporation
FMD : First Marblehead Corporation
FMER : FirstMerit Corporation
FMI : Foundation Medicine, Inc.
FNB : F.N.B. Corporation
FNFG : First Niagara Financial Group Inc.
FNF : Fidelity National Financial, Inc.
FNGN : Financial Engines, Inc.
FNHC : Federated National Holding Company
FNLC : First Bancorp, Inc
FNSR : Finisar Corporation
FN : Fabrinet
FOE : Ferro Corporation
FOLD : Amicus Therapeutics, Inc.
FORM : FormFactor, Inc.
FORR : Forrester Research, Inc.
FOR : Forestar Group Inc
FOSL : Fossil Group, Inc.
FOXA : Twenty-First Century Fox, Inc.
FOXF : Fox Factory Holding Corp.
FOX : Twenty-First Century Fox, Inc.
FPO : First Potomac Realty Trust
FPRX : Five Prime Therapeutics, Inc.
FRAN : Francesca's Holdings Corporation
FRBK : Republic First Bancorp, Inc.
FRC : FIRST REPUBLIC BANK
FRED : Fred's, Inc.
FRGI : Fiesta Restaurant Group, Inc.
FRME : First Merchants Corporation
FRM : Furmanite Corporation
FRO : Frontline Ltd.
FRP : FairPoint Communications, Inc.
FRSH : Papa Murphy's Holdings, Inc.
FRT : Federal Realty Investment Trust
FR : First Industrial Realty Trust, Inc.
FSC : Fifth Street Finance Corp.
FSGI : First Security Group, Inc.
FSLR : First Solar, Inc.
FSL : Freescale Semiconductor, Ltd.
FSP : Franklin Street Properties Corp.
FSS : Federal Signal Corporation
FSTR : L.B. Foster Company
FSYS : Fuel Systems Solutions, Inc.
FTD : FTD Companies, Inc.
FTI : FMC Technologies, Inc.
FTK : Flotek Industries, Inc.
FTNT : Fortinet, Inc.
FTR : Frontier Communications Corporation
FUEL : Rocket Fuel Inc.
FULT : Fulton Financial Corporation
FUL : H. B. Fuller Company
FUR : Winthrop Realty Trust
FVE : Five Star Quality Care, Inc.
FWM : Fairway Group Holdings Corp.
FWRD : Forward Air Corporation
FXCB : Fox Chase Bancorp, Inc.
FXCM : FXCM Inc.
FXEN : FX Energy, Inc.
F : Ford Motor Company
GABC : German American Bancorp, Inc.
GAIA : Gaiam, Inc.
GAIN : Gladstone Investment Corporation
GALE : Galena Biopharma, Inc.
GALT : Galectin Therapeutics Inc.
GARS : Garrison Capital Inc.
GAS : AGL Resources, Inc.
GBCI : Glacier Bancorp, Inc.
GBDC : Golub Capital BDC, Inc.
GBLI : Global Indemnity plc
GBL : Gamco Investors, Inc.
GBNK : Guaranty Bancorp
GBX : Greenbrier Companies, Inc.
GB : Greatbatch, Inc.
GCAP : GAIN Capital Holdings, Inc.
GCA : Global Cash Access Holdings, Inc.
GCO : Genesco Inc.
GDOT : Green Dot Corporation
GDP : Goodrich Petroleum Corporation
GD : General Dynamics Corporation
GEF : Greif Bros. Corporation
GEOS : Geospace Technologies Corporation
GEO : Geo Group Inc
GERN : Geron Corporation
GES : Guess?, Inc.
GE : General Electric Company
GFF : Griffon Corporation
GFN : General Finance Corporation
GGG : Graco Inc.
GGP : General Growth Properties, Inc.
GHC : Graham Holdings Company
GHDX : Genomic Health, Inc.
GHL : Greenhill & Co., Inc.
GHM : Graham Corporation
GIFI : Gulf Island Fabrication, Inc.
GIII : G-III Apparel Group, LTD.
GILD : Gilead Sciences, Inc.
GIMO : Gigamon Inc.
GIS : General Mills, Inc.
GK : G&K Services, Inc.
GLAD : Gladstone Capital Corporation
GLDD : Great Lakes Dredge & Dock Corporation
GLF : GulfMark Offshore, Inc.
GLNG : Golar LNG Limited
GLOG : GasLog LP.
GLPW : Global Power Equipment Group Inc
GLRE : Greenlight Reinsurance, Ltd.
GLRI : Glori Energy Inc
GLT : Glatfelter
GLUU : Glu Mobile Inc.
GLW : Corning Incorporated
GMAN : Gordmans Stores, Inc.
GMCR : Keurig Green Mountain, Inc.
GMED : Globus Medical, Inc.
GME : Gamestop Corporation
GMO : General Moly, Inc
GMT : GATX Corporation
GM : General Motors Company
GNCA : Genocea Biosciences, Inc.
GNCMA : General Communication, Inc.
GNC : GNC Holdings, Inc.
GNE : Genie Energy Ltd.
GNMK : GenMark Diagnostics, Inc.
GNRC : Generac Holdlings Inc.
GNTX : Gentex Corporation
GNW : Genworth Financial Inc
GOGO : Gogo Inc.
GOLD : Randgold Resources Limited
GOOD : Gladstone Commercial Corporation
GOOGL : Google Inc.
GOOG : Google Inc.
GORO : Gold Resource Corporation
GOV : Government Properties Income Trust
GPC : Genuine Parts Company
GPI : Group 1 Automotive, Inc.
GPK : Graphic Packaging Holding Company
GPN : Global Payments Inc.
GPOR : Gulfport Energy Corporation
GPRE : Green Plains, Inc.
GPS : Gap, Inc.
GPT : Gramercy Property Trust Inc.
GPX : GP Strategies Corporation
GRA : W.R. Grace & Co.
GRC : Gorman-Rupp Company
GRIF : Griffin Land & Nurseries, Inc.
GRMN : Garmin Ltd.
GRPN : Groupon, Inc.
GRUB : GrubHub Inc.
GSAT : Globalstar, Inc.
GSBC : Great Southern Bancorp, Inc.
GSIG : GSI Group, Inc.
GSIT : GSI Technology, Inc.
GSM : Globe Specialty Metals Inc.
GSOL : Global Sources Ltd.
GST : Gastar Exploration Inc.
GSVC : GSV Capital Corp
GS : Goldman Sachs Group, Inc.
GTI : GrafTech International Ltd
GTLS : Chart Industries, Inc.
GTN : Gray Television, Inc.
GTS : Triple-S Management Corporation
GTT : GTT Communications, Inc.
GTXI : GTx, Inc.
GTY : Getty Realty Corporation
GT : The Goodyear Tire & Rubber Company
GUID : Guidance Software, Inc.
GVA : Granite Construction Incorporated
GWRE : Guidewire Software, Inc.
GWR : Genesee & Wyoming, Inc.
GWW : W.W. Grainger, Inc.
GXP : Great Plains Energy Inc
G : Genpact Limited
HAE : Haemonetics Corporation
HAFC : Hanmi Financial Corporation
HAIN : The Hain Celestial Group, Inc.
HALL : Hallmark Financial Services, Inc.
HALO : Halozyme Therapeutics, Inc.
HAL : Halliburton Company
HAR : Harman International Industries, Incorporated
HASI : Hannon Armstrong Sustainable Infrastructure Capital, Inc.
HAS : Hasbro, Inc.
HAWK : Blackhawk Network Holdings, Inc.
HAYN : Haynes International, Inc.
HA : Hawaiian Holdings, Inc.
HBAN : Huntington Bancshares Incorporated
HBCP : Home Bancorp, Inc.
HBHC : Hancock Holding Company
HBIO : Harvard Bioscience, Inc.
HBI : Hanesbrands Inc.
HBNC : Horizon Bancorp
HCA : HCA Holdings, Inc.
HCBK : Hudson City Bancorp, Inc.
HCCI : Heritage-Crystal Clean, Inc.
HCC : HCC Insurance Holdings, Inc.
HCI : HCI Group, Inc.
HCKT : The Hackett Group, Inc.
HCN : Health Care REIT, Inc.
HCOM : Hawaiian Telcom Holdco, Inc.
HCP : HCP, Inc.
HCSG : Healthcare Services Group, Inc.
HDNG : Hardinge, Inc.
HD : Home Depot, Inc.
HEAR : Turtle Beach Corporation
HEES : H&E Equipment Services, Inc.
HEI : Heico Corporation
HELE : Helen of Troy Limited
HELI : CHC Group Ltd.
HEOP : Heritage Oaks Bancorp
HERO : Hercules Offshore, Inc.
HES : Hess Corporation
HE : Hawaiian Electric Industries, Inc.
HFC : HollyFrontier Corporation
HFWA : Heritage Financial Corporation
HF : HFF, Inc.
HGG : HHGregg, Inc.
HGR : Hanger, Inc.
HHC : Howard Hughes Corporation
HHS : Harte-Hanks, Inc.
HIBB : Hibbett Sports, Inc.
HIFS : Hingham Institution for Savings
HIG : Hartford Financial Services Group, Inc.
HIIQ : Health Insurance Innovations, Inc.
HII : Huntington Ingalls Industries, Inc.
HILL : Dot Hill Systems Corporation
HIL : Hill International, Inc.
HIVE : Aerohive Networks, Inc.
HIW : Highwoods Properties, Inc.
HI : Hillenbrand Inc
HK : Halcon Resources Corporation
HLF : Herbalife LTD.
HLIT : Harmonic Inc.
HLS : HealthSouth Corporation
HLX : Helix Energy Solutions Group, Inc.
HL : Hecla Mining Company
HME : Home Properties, Inc.
HMHC : Houghton Mifflin Harcourt Company
HMN : Horace Mann Educators Corporation
HMPR : Hampton Roads Bankshares Inc
HMST : HomeStreet, Inc.
HMSY : HMS Holdings Corp
HMTV : Hemisphere Media Group, Inc.
HNH : Handy & Harman Ltd.
HNI : HNI Corporation
HNRG : Hallador Energy Company
HNR : Harvest Natural Resources Inc
HNT : Health Net Inc.
HOFT : Hooker Furniture Corporation
HOG : Harley-Davidson, Inc.
HOLX : Hologic, Inc.
HOMB : Home BancShares, Inc.
HON : Honeywell International Inc.
HOS : Hornbeck Offshore Services
HOT : Starwood Hotels & Resorts Worldwide, Inc.
HOV : Hovnanian Enterprises Inc
HPP : Hudson Pacific Properties, Inc.
HPQ : Hewlett-Packard Company
HPT : Hospitality Properites Trust
HPY : Heartland Payment Systems, Inc.
HP : Helmerich & Payne, Inc.
HRB : H&R Block, Inc.
HRC : Hill-Rom Holdings Inc
HRG : Harbinger Group Inc
HRL : Hormel Foods Corporation
HRS : Harris Corporation
HRTG : Heritage Insurance Holdings, Inc.
HRTX : Heron Therapeutics, Inc.
HRZN : Horizon Technology Finance Corporation
HR : Healthcare Realty Trust Incorporated
HSC : Harsco Corporation
HSIC : Henry Schein, Inc.
HSII : Heidrick & Struggles International, Inc.
HSNI : HSN, Inc.
HSP : Hospira Inc
HSTM : HealthStream, Inc.
HST : Host Hotels & Resorts, Inc.
HSY : Hershey Company
HTA : Healthcare Trust of America, Inc.
HTBI : HomeTrust Bancshares, Inc.
HTBK : Heritage Commerce Corp
HTCH : Hutchinson Technology Incorporated
HTGC : Hercules Technology Growth Capital, Inc.
HTH : Hilltop Holdings Inc.
HTLD : Heartland Express, Inc.
HTLF : Heartland Financial USA, Inc.
HTS : Hatteras Financial Corp
HTWR : Heartware International, Inc.
HTZ : Hertz Global Holdings, Inc
HT : Hersha Hospitality Trust
HUB_B : Hubbell Inc
HUBG : Hub Group, Inc.
HUM : Humana Inc.
HUN : Huntsman Corporation
HURC : Hurco Companies, Inc.
HURN : Huron Consulting Group Inc.
HVT : Haverty Furniture Companies, Inc.
HWAY : Healthways, Inc.
HWCC : Houston Wire & Cable Company
HWKN : Hawkins, Inc.
HW : Headwaters Incorporated
HXL : Hexcel Corporation
HY : Hyster-Yale Materials Handling, Inc.
HZNP : Horizon Pharma, Inc.
HZO : MarineMax, Inc.
H : Hyatt Hotels Corporation
IACI : IAC/InterActiveCorp
IART : Integra LifeSciences Holdings Corporation
IBCP : Independent Bank Corporation
IBKC : IBERIABANK Corporation
IBKR : Interactive Brokers Group, Inc.
IBM : International Business Machines Corporation
IBOC : International Bancshares Corporation
IBP : Installed Building Products, Inc.
IBTX : Independent Bank Group, Inc
ICE : Intercontinental Exchange Inc.
ICFI : ICF International, Inc.
ICON : Iconix Brand Group, Inc.
ICPT : Intercept Pharmaceuticals, Inc.
ICUI : ICU Medical, Inc.
IDA : IDACORP, Inc.
IDCC : InterDigital, Inc.
IDRA : Idera Pharmaceuticals, Inc.
IDTI : Integrated Device Technology, Inc.
IDT : IDT Corporation
IDXX : IDEXX Laboratories, Inc.
IEX : IDEX Corporation
IFF : Internationa Flavors & Fragrances, Inc.
IFT : Imperial Holdings, Inc.
IGT : International Game Technology
IG : IGI Laboratories, Inc.
IHC : Independence Holding Company
IHS : IHS Inc.
IIIN : Insteel Industries, Inc.
III : Information Services Group, Inc.
IILG : Interval Leisure Group, Inc.
IIVI : II-VI Incorporated
ILMN : Illumina, Inc.
IL : IntraLinks Holdings, Inc.
IMGN : ImmunoGen, Inc.
IMI : Intermolecular, Inc.
IMKTA : Ingles Markets, Incorporated
IMMR : Immersion Corporation
IMMU : Immunomedics, Inc.
IMN : Imation Corporation
IMPV : Imperva, Inc.
IM : Ingram Micro Inc.
INAP : Internap Network Services Corporation
INCY : Incyte Corporation
INDB : Independent Bank Corp.
INFA : Informatica Corporation
INFI : Infinity Pharmaceuticals, Inc.
INFN : Infinera Corporation
INGN : Inogen, Inc
INGR : Ingredion Incorporated
ININ : Interactive Intelligence Group, Inc.
INN : Summit Hotel Properties, Inc.
INO : Inovio Pharmaceuticals, Inc.
INSM : Insmed, Inc.
INSY : Insys Therapeutics, Inc.
INTC : Intel Corporation
INTL : INTL FCStone Inc.
INTU : Intuit Inc.
INTX : Intersections, Inc.
INT : World Fuel Services Corporation
INVN : InvenSense, Inc.
INWK : InnerWorkings, Inc.
IOSP : Innospec Inc.
IO : Ion Geophysical Corporation
IPAR : Inter Parfums, Inc.
IPCC : Infinity Property and Casualty Corporation
IPCM : IPC The Hospitalist Company, Inc.
IPGP : IPG Photonics Corporation
IPG : Interpublic Group of Companies, Inc.
IPHI : Inphi Corporation
IPHS : Innophos Holdings, Inc.
IPI : Intrepid Potash, Inc
IPXL : Impax Laboratories, Inc.
IP : International Paper Company
IQNT : Inteliquent, Inc.
IRBT : iRobot Corporation
IRC : Inland Real Estate Corporation
IRDM : Iridium Communications Inc
IRET : Investors Real Estate Trust
IRG : Ignite Restaurant Group, Inc.
IRM : Iron Mountain Incorporated
IRWD : Ironwood Pharmaceuticals, Inc.
IR : Ingersoll-Rand plc
ISBC : Investors Bancorp, Inc.
ISCA : International Speedway Corporation
ISH : International Shipholding Corporation
ISIL : Intersil Corporation
ISIS : Isis Pharmaceuticals, Inc.
ISLE : Isle of Capri Casinos, Inc.
ISRG : Intuitive Surgical, Inc.
ISRL : Isramco, Inc.
ISSC : Innovative Solutions and Support, Inc.
ISSI : Integrated Silicon Solution, Inc.
ITCI : Intra-Cellular Therapies Inc.
ITC : ITC Holdings Corp.
ITG : Investment Technology Group, Inc.
ITIC : Investors Title Company
ITRI : Itron, Inc.
ITT : ITT Corporation
ITW : Illinois Tool Works Inc.
IT : Gartner, Inc.
IVAC : Intevac, Inc.
IVC : Invacare Corporation
IVR : INVESCO MORTGAGE CAPITAL INC
IVZ : Invesco Plc
IXYS : IXYS Corporation
I : Intelsat S.A.
JACK : Jack In The Box Inc.
JAH : Jarden Corporation
JAKK : JAKKS Pacific, Inc.
JBHT : J.B. Hunt Transport Services, Inc.
JBLU : JetBlue Airways Corporation
JBL : Jabil Circuit, Inc.
JBSS : John B. Sanfilippo & Son, Inc.
JBT : John Bean Technologies Corporation
JCI : Johnson Controls, Inc.
JCOM : j2 Global, Inc.
JCP : J.C. Penney Company, Inc. Holding Company
JDSU : JDS Uniphase Corporation
JEC : Jacobs Engineering Group Inc.
JGW : JGWPT Holdings Inc.
JIVE : Jive Software, Inc.
JJSF : J & J Snack Foods Corp.
JKHY : Jack Henry & Associates, Inc.
JLL : Jones Lang LaSalle Incorporated
JMBA : Jamba, Inc.
JNJ : Johnson & Johnson
JNPR : Juniper Networks, Inc.
JNS : Janus Capital Group, Inc
JOE : St. Joe Company
JONE : Jones Energy, Inc.
JOUT : Johnson Outdoors Inc.
JOY : Joy Global Inc.
JPM : JP Morgan Chase
JW_A : John Wiley & Sons, Inc.
JWN : Nordstrom, Inc.
KAI : Kadant Inc
KALU : Kaiser Aluminum Corporation
KAMN : Kaman Corporation
KAR : KAR Auction Services, Inc
KBH : KB Home
KBR : KBR, Inc.
KCG : KCG Holdings, Inc.
KCLI : Kansas City Life Insurance Company
KEG : Key Energy Services, Inc.
KELYA : Kelly Services, Inc.
KEM : Kemet Corporation
KERX : Keryx Biopharmaceuticals, Inc.
KEX : Kirby Corporation
KEYW : The KEYW Holding Corporation
KEY : KeyCorp
KFRC : Kforce, Inc.
KFY : Korn/Ferry International
KIM : Kimco Realty Corporation
KIN : Kindred Biosciences, Inc.
KIRK : Kirkland's, Inc.
KKD : Krispy Kreme Doughnuts, Inc.
KLAC : KLA-Tencor Corporation
KMB : Kimberly-Clark Corporation
KMG : KMG Chemicals, Inc.
KMI : Kinder Morgan, Inc.
KMPR : Kemper Corporation
KMT : Kennametal Inc.
KMX : CarMax Inc
KND : Kindred Healthcare, Inc.
KNL : Knoll, Inc.
KNX : Knight Transportation, Inc.
KODK : Eastman Kodak Company
KOPN : (KOPN) Prices, Dividends, Splits and Trading Volume
KOP : Koppers Holdings Inc.
KORS : Michael Kors Holdings Limited
KOS : Kosmos Energy Ltd.
KO : Coca-Cola Company
KPTI : Karyopharm Therapeutics Inc.
KRA : Kraton Performance Polymers, Inc
KRC : Kilroy Realty Corporation
KRG : Kite Realty Group Trust
KRNY : Kearny Financial
KRO : Kronos Worldwide Inc
KR : Kroger Company
KSS : Kohl's Corporation
KSU : Kansas City Southern
KS : KapStone Paper and Packaging Corporation
KTOS : Kratos Defense & Security Solutions, Inc.
KTWO : K2M Group Holdings, Inc.
KVHI : KVH Industries, Inc.
KWR : Quaker Chemical Corporation
KW : Kennedy-Wilson Holdings Inc.
KYTH : Kythera Biopharmaceuticals, Inc.
K : Kellogg Company
LABL : Multi-Color Corporation
LADR : (LADR) Prices, Dividends, Splits and Trading Volume
LAD : Lithia Motors, Inc.
LAMR : Lamar Advertising Company
LANC : Lancaster Colony Corporation
LAYN : Layne Christensen Company
LAZ : Lazard Ltd.
LBAI : Lakeland Bancorp, Inc.
LBMH : (LBMH) Prices, Dividends, Splits and Trading Volume
LBTYA : Liberty Global plc
LBY : Libbey, Inc.
LB : L Brands, Inc.
LCI : Lannett Co Inc
LCNB : LCNB Corporation
LCUT : Lifetime Brands, Inc.
LDL : Lydall, Inc.
LDOS : Leidos Holdings, Inc.
LDRH : (LDRH) Prices, Dividends, Splits and Trading Volume
LDR : Landauer, Inc.
LEAF : Springleaf Holdings, Inc.
LEA : Lear Corporation
LECO : Lincoln Electric Holdings, Inc.
LEE : (LEE) Prices, Dividends, Splits and Trading Volume
LEG : Leggett & Platt, Incorporated
LEN : Lennar Corporation
LE : Lands' End, Inc.
LFUS : Littelfuse, Inc.
LFVN : Lifevantage Corporation
LF : Leapfrog Enterprises Inc
LGF : Lions Gate Entertainment Corporation
LGIH : (LGIH) Prices, Dividends, Splits and Trading Volume
LGND : Ligand Pharmaceuticals Incorporated
LG : Laclede Group, Inc.
LHCG : LHC Group
LHO : LaSalle Hotel Properties
LH : Laboratory Corporation of America Holdings
LII : Lennox International, Inc.
LINC : Lincoln Educational Services Corporation
LION : Fidelity Southern Corporation
LIOX : Lionbridge Technologies, Inc.
LKFN : Lakeland Financial Corporation
LKQ : LKQ Corporation
LLL : L-3 Communications Holdings, Inc.
LLNW : Limelight Networks, Inc.
LLTC : Linear Technology Corporation
LLY : Eli Lilly and Company
LL : Lumber Liquidators Holdings, Inc
LMCA : Liberty Media Corporation
LMIA : LMI Aerospace, Inc.
LMNR : Limoneira Co
LMNX : Luminex Corporation
LMOS : Lumos Networks Corp.
LMT : Lockheed Martin Corporation
LM : Legg Mason, Inc.
LNCE : Snyder's-Lance, Inc.
LNC : Lincoln National Corporation
LNDC : Landec Corporation
LNG : Cheniere Energy, Inc.
LNKD : LinkedIn Corporation
LNN : Lindsay Corporation
LNT : Alliant Energy Corporation
LOCK : LifeLock, Inc.
LOGM : LogMein, Inc.
LOPE : Grand Canyon Education, Inc.
LORL : Loral Space and Communications, Inc.
LOV : Spark Networks, Inc.
LOW : Lowe's Companies, Inc.
LPG : Dorian LPG Ltd.
LPI : Laredo Petroleum, Inc.
LPLA : LPL Financial Holdings Inc.
LPNT : LifePoint Hospitals, Inc.
LPSN : LivePerson, Inc.
LPX : Louisiana-Pacific Corporation
LQDT : Liquidity Services, Inc.
LQ : La Quinta Holdings Inc.
LRCX : Lam Research Corporation
LRN : K12 Inc
LSCC : Lattice Semiconductor Corporation
LSTR : Landstar System, Inc.
LTC : LTC Properties, Inc.
LTS : Ladenburg Thalmann Financial Services Inc
LUB : Luby's, Inc.
LUK : Leucadia National Corporation
LUV : Southwest Airlines Company
LVLT : Level 3 Communications, Inc.
LVNTA : Liberty Interactive Corporation
LVS : Las Vegas Sands Corp.
LWAY : Lifeway Foods, Inc.
LXFT : (LXFT) Prices, Dividends, Splits and Trading Volume
LXK : Lexmark International, Inc.
LXP : Lexington Realty Trust
LXRX : Lexicon Pharmaceuticals, Inc.
LXU : Lsb Industries Inc.
LYB : LyondellBasell Industries NV
LYTS : LSI Industries Inc.
LYV : Live Nation Entertainment, Inc.
LZB : La-Z-Boy Incorporated
L : Loews Corporation
MACK : Merrimack Pharmaceuticals, Inc.
MAC : Macerich Company
MAIN : Main Street Capital Corporation
MANH : Manhattan Associates, Inc.
MANT : ManTech International Corporation
MAN : ManpowerGroup
MAR : Marriott International
MASI : Masimo Corporation
MAS : Masco Corporation
MATW : Matthews International Corporation
MATX : Matson, Inc.
MAT : Mattel, Inc.
MA : Mastercard Incorporated
MBFI : MB Financial Inc.
MBII : (MBII) Prices, Dividends, Splits and Trading Volume
MBI : MBIA, Inc.
MBRG : Middleburg Financial Corporation
MBUU : (MBUU) Prices, Dividends, Splits and Trading Volume
MBVT : Merchants Bancshares, Inc.
MBWM : Mercantile Bank Corporation
MCBC : Macatawa Bank Corporation
MCC : Medley Capital Corporation
MCD : McDonald's Corporation
MCF : Contango Oil & Gas Company
MCGC : MCG Capital Corporation
MCHP : Microchip Technology Incorporated
MCHX : Marchex, Inc.
MCK : McKesson Corporation
MCO : Moody's Corporation
MCRI : Monarch Casino & Resort, Inc.
MCRL : Micrel, Incorporated
MCS : Marcus Corporation
MCY : Mercury General Corporation
MC : Moelis & Company
MDAS : MedAssets, Inc.
MDCA : MDC Partners Inc.
MDCO : The Medicines Company
MDC : M.D.C. Holdings, Inc.
MDLZ : Mondelez International, Inc.
MDP : Meredith Corporation
MDRX : Allscripts Healthcare Solutions, Inc.
MDR : McDermott International, Inc.
MDSO : Medidata Solutions, Inc.
MDT : Medtronic, Inc.
MDU : MDU Resources Group, Inc.
MDVN : Medivation, Inc.
MDXG : MiMedx Group, Inc
MD : Mednax, Inc
MED : MEDIFAST INC
MEG : Media General, Inc.
MEIP : MEI Pharma, Inc.
MEI : Methode Electronics, Inc.
MENT : Mentor Graphics Corporation
METR : Metro Bancorp, Inc
MET : MetLife, Inc.
MFA : MFA Financial, Inc.
MFLX : Multi-Fineline Electronix, Inc.
MFRM : Mattress Firm Holding Corp.
MGEE : MGE Energy Inc.
MGI : Moneygram International, Inc.
MGLN : Magellan Health Services, Inc.
MGM : MGM Resorts International
MGNX : (MGNX) Prices, Dividends, Splits and Trading Volume
MGRC : McGrath RentCorp
MG : Mistras Group Inc
MHFI : McGraw Hill Financial, Inc.
MHGC : Morgans Hotel Group Co.
MHK : Mohawk Industries, Inc.
MHLD : Maiden Holdings, Ltd.
MHO : M/I Homes, Inc.
MHR : Magnum Hunter Resources Corporation
MIDD : The Middleby Corporation
MILL : Miller Energy Resources, Inc.
MIL : (MIL) Prices, Dividends, Splits and Trading Volume
MIND : Mitcham Industries, Inc.
MINI : Mobile Mini, Inc.
MITK : Mitek Systems, Inc.
MITT : AG Mortgage Investment Trust, Inc.
MJN : Mead Johnson Nutrition Company
MKC : McCormick & Company, Incorporated
MKL : Markel Corporation
MKSI : MKS Instruments, Inc.
MKTO : Marketo, Inc.
MKTX : MarketAxess Holdings, Inc.
MLAB : Mesa Laboratories, Inc.
MLHR : Herman Miller, Inc.
MLI : Mueller Industries, Inc.
MLM : Martin Marietta Materials, Inc.
MLNK : ModusLink Global Solutions, Inc
MLR : Miller Industries, Inc.
MMC : Marsh & McLennan Companies, Inc.
MMI : (MMI) Prices, Dividends, Splits and Trading Volume
MMM : 3M Company
MMSI : Merit Medical Systems, Inc.
MMS : Maximus, Inc.
MM : Millennial Media, Inc.
MNI : McClatchy Company
MNKD : MannKind Corporation
MNK : (MNK) Prices, Dividends, Splits and Trading Volume
MNRO : Monro Muffler Brake, Inc.
MNR : Monmouth Real Estate Investment Corporation
MNST : Monster Beverage Corporation
MNTA : Momenta Pharmaceuticals, Inc.
MNTX : Manitex International, Inc.
MN : Manning & Napier, Inc.
MODN : Model N, Inc.
MOD : Modine Manufacturing Company
MOFG : MidWestOne Financial Group, Inc.
MOG_A : Moog Inc.
MOH : Molina Healthcare Inc
MON : Monsanto Company
MORN : Morningstar, Inc.
MOSY : MoSys, Inc.
MOS : Mosaic Company
MOV : Movado Group Inc.
MO : Altria Group
MPAA : (MPAA) Prices, Dividends, Splits and Trading Volume
MPC : Marathon Petroleum Corporation
MPO : Midstates Petroleum Company, Inc.
MPWR : Monolithic Power Systems, Inc.
MPW : Medical Properties Trust, Inc.
MPX : Marine Products Corporation
MRCY : Mercury Systems Inc
MRC : MRC Global Inc.
MRGE : Merge Healthcare Incorporated.
MRH : Montpelier Re Holdings Ltd.
MRIN : Marin Software Incorporated
MRK : Merck & Company, Inc.
MRLN : Marlin Business Services Corp.
MRO : Marathon Oil Corporation
MRTN : Marten Transport, Ltd.
MRTX : (MRTX) Prices, Dividends, Splits and Trading Volume
MRVL : Marvell Technology Group Ltd.
MSA : MSA Safety Incorporporated
MSCC : Microsemi Corporation
MSCI : MSCI Inc
MSEX : Middlesex Water Company
MSFG : MainSource Financial Group, Inc.
MSFT : Microsoft Corporation
MSG : The Madison Square Garden Company
MSI : Motorola Solutions, Inc.
MSL : MidSouth Bancorp
MSM : MSC Industrial Direct Company, Inc.
MSO : Martha Stewart Living Omnimedia, Inc.
MSTR : MicroStrategy Incorporated
MS : Morgan Stanley
MTB : M&T Bank Corporation
MTDR : Matador Resources Company
MTD : Mettler-Toledo International, Inc.
MTGE : American Capital Mortgage Investment Corp.
MTG : MGIC Investment Corporation
MTH : Meritage Corporation
MTN : Vail Resorts, Inc.
MTOR : Meritor, Inc.
MTRN : Materion Corporation
MTRX : Matrix Service Company
MTSC : MTS Systems Corporation
MTSI : M/A-COM Technology Solutions Holdings, Inc.
MTW : Manitowoc Company, Inc.
MTX : Minerals Technologies Inc.
MTZ : MasTec, Inc.
MUR : Murphy Oil Corporation
MUSA : (MUSA) Prices, Dividends, Splits and Trading Volume
MU : Micron Technology, Inc.
MVC : MVC Capital, Inc.
MWA : MUELLER WATER PRODUCTS
MWW : Monster Worldwide, Inc.
MW : Men's Wearhouse, Inc.
MXIM : Maxim Integrated Products, Inc.
MXL : MaxLinear, Inc
MXWL : Maxwell Technologies, Inc.
MYCC : ClubCorp Holdings, Inc.
MYE : Myers Industries, Inc.
MYGN : Myriad Genetics, Inc.
MYL : Mylan Inc.
MYRG : MYR Group, Inc.
M : Macy's Inc
NADL : (NADL) Prices, Dividends, Splits and Trading Volume
NANO : Nanometrics Incorporated
NATH : Nathan's Famous, Inc.
NATI : National Instruments Corporation
NATL : National Interstate Corporation
NATR : Nature's Sunshine Products, Inc.
NAT : Nordic American Tankers Limited
NAVB : Navidea Biopharmaceuticals, Inc.
NAVG : The Navigators Group, Inc.
NAVI : Navient Corporation
NAV : Navistar International Corporation
NBBC : NewBridge Bancorp
NBHC : National Bank Holdings Corporation
NBIX : Neurocrine Biosciences, Inc.
NBL : Noble Energy Inc.
NBTB : NBT Bancorp Inc.
NCI : Navigant Consulting, Inc.
NCLH : Norwegian Cruise Line Holdings Ltd.
NCMI : National CineMedia, Inc.
NCR : NCR Corporation
NCS : NCI Building Systems, Inc.
NC : NACCO Industries, Inc.
NDAQ : The NASDAQ OMX Group, Inc.
NDLS : (NDLS) Prices, Dividends, Splits and Trading Volume
NDSN : Nordson Corporation
NEE : NextEra Energy, Inc.
NEM : Newmont Mining Corporation
NEOG : Neogen Corporation
NEON : Neonode Inc.
NEO : NeoGenomics, Inc.
NES : Nuverra Environmental Solutions, Inc.
NETE : Net Element, Inc.
NEU : NewMarket Corporation
NEWM : (NEWM) Prices, Dividends, Splits and Trading Volume
NEWP : Newport Corporation
NEWS : NewStar Financial, Inc.
NE : Noble Corporation
NFBK : Northfield Bancorp, Inc.
NFG : National Fuel Gas Company
NFLX : Netflix, Inc.
NFX : Newfield Exploration Company
NGHC : National General Holdings Corp
NGS : Natural Gas Services Group, Inc.
NGVC : Natural Grocers by Vitamin Cottage, Inc.
NHC : National HealthCare Corporation
NHI : National Health Investors, Inc.
NICK : Nicholas Financial, Inc.
NIHD : NII Holdings, Inc.
NILE : Blue Nile, Inc.
NI : NiSource, Inc
NJR : NewJersey Resources Corporation
NKE : Nike, Inc.
NKSH : National Bankshares, Inc.
NKTR : Nektar Therapeutics
NLNK : NewLink Genetics Corporation
NLSN : Nielsen N.V.
NLS : Nautilus Group, Inc.
NLY : Annaly Capital Management Inc
NL : NL Industries, Inc.
NMBL : (NMBL) Prices, Dividends, Splits and Trading Volume
NMFC : New Mountain Finance Corporation
NMIH : (NMIH) Prices, Dividends, Splits and Trading Volume
NMRX : Numerex Corp.
NM : (NM) Prices, Dividends, Splits and Trading Volume
NNA : (NNA) Prices, Dividends, Splits and Trading Volume
NNBR : NN, Inc.
NNI : Nelnet, Inc.
NNVC : (NNVC) Prices, Dividends, Splits and Trading Volume
NOC : Northrop Grumman Corporation
NOG : Northern Oil and Gas, Inc.
NOR : Noranda Aluminum Holding Corporation
NOV : National Oilwell Varco, Inc.
NOW : ServiceNow, Inc.
NPBC : National Penn Bancshares, Inc.
NPK : National Presto Industries, Inc.
NPO : Enpro Industries
NPTN : NeoPhotonics Corporation
NP : Neenah Paper, Inc.
NRCIA : National Research Corporation
NRG : NRG Energy, Inc.
NRIM : Northrim BanCorp Inc
NRZ : New Residential Investment Corp.
NR : Newpark Resources, Inc.
NSC : Norfolk Souther Corporation
NSIT : Insight Enterprises, Inc.
NSM : Nationstar Mortgage Holdings Inc.
NSPH : Nanosphere, Inc.
NSP : Insperity, Inc.
NSR : Neustar, Inc.
NSTG : (NSTG) Prices, Dividends, Splits and Trading Volume
NTAP : NetApp, Inc.
NTCT : NetScout Systems, Inc.
NTGR : NETGEAR, Inc.
NTK : Nortek Inc.
NTLS : NTELOS Holdings Corp.
NTRI : NutriSystem Inc
NTRS : Northern Trust Corporation
NUAN : Nuance Communications, Inc.
NUE : Nucor Corporation
NUS : Nu Skin Enterprises, Inc.
NUTR : Nutraceutical International Corporation
NUVA : NuVasive, Inc.
NVAX : Novavax, Inc.
NVDA : NVIDIA Corporation
NVEC : NVE Corporation
NVR : NVR, Inc.
NWBI : Northwest Bancshares, Inc.
NWBO : (NWBO) Prices, Dividends, Splits and Trading Volume
NWE : NorthWestern Corporation
NWHM : (NWHM) Prices, Dividends, Splits and Trading Volume
NWLI : National Western Life Insurance Company
NWL : Newell Rubbermaid Inc.
NWN : Northwest Natural Gas Company
NWPX : Northwest Pipe Company
NWSA : News Corporation
NWY : New York & Company, Inc.
NXST : Nexstar Broadcasting Group, Inc.
NXTM : NxStage Medical, Inc.
NX : Quanex Building Products Corporation
NYCB : New York Community Bancorp, Inc.
NYLD : (NYLD) Prices, Dividends, Splits and Trading Volume
NYMT : New York Mortgage Trust, Inc.
NYNY : Empire Resorts, Inc.
NYRT : New York REIT, Inc.
NYT : New York Times Company
N : Netsuite Inc
OAS : Oasis Petroleum Inc.
OB : OneBeacon Insurance Group, Ltd.
OCFC : OceanFirst Financial Corp.
OCLR : (OCLR) Prices, Dividends, Splits and Trading Volume
OCN : Ocwen Financial Corporation
OCR : Omnicare, Inc.
OC : Owens Corning Inc
ODC : Oil-Dri Corporation Of America
ODFL : Old Dominion Freight Line, Inc.
ODP : Office Depot, Inc.
OFC : Corporate Office Properties Trust
OFG : OFG Bancorp
OFIX : Orthofix International N.V.
OFLX : Omega Flex, Inc.
OGE : OGE Energy Corporation
OGS : (OGS) Prices, Dividends, Splits and Trading Volume
OGXI : OncoGenex Pharmaceuticals Inc.
OHI : Omega Healthcare Investors, Inc.
OHRP : (OHRP) Prices, Dividends, Splits and Trading Volume
OII : Oceaneering International, Inc.
OIS : Oil States International, Inc.
OI : Owens-Illinois, Inc.
OKE : ONEOK, Inc.
OKSB : Southwest Bancorp, Inc.
OLBK : (OLBK) Prices, Dividends, Splits and Trading Volume
OLED : Universal Display Corporation
OLN : Olin Corporation
OLP : One Liberty Properties, Inc.
OMCL : Omnicell, Inc.
OMC : Omnicom Group Inc.
OMED : (OMED) Prices, Dividends, Splits and Trading Volume
OMER : Omeros Corporation
OMEX : Odyssey Marine Exploration, Inc.
OME : Omega Protein Corporation
OMG : OM Group, Inc.
OMI : Owens & Minor, Inc.
OMN : OMNOVA Solutions Inc.
ONB : Old National Bancorp
ONE : Higher One Holdings, Inc.
ONTY : (ONTY) Prices, Dividends, Splits and Trading Volume
ONVO : (ONVO) Prices, Dividends, Splits and Trading Volume
OPB : Opus Bank
OPHT : (OPHT) Prices, Dividends, Splits and Trading Volume
OPK : Opko Health Inc
OPWR : Opower, Inc.
OPY : Oppenheimer Holdings, Inc.
ORA : Ormat Technologies, Inc.
ORBC : ORBCOMM Inc.
ORCL : Oracle Corporation
OREX : Orexigen Therapeutics, Inc.
ORIT : Oritani Financial Corp.
ORI : Old Republic International Corporation
ORLY : O'Reilly Automotive, Inc.
ORM : Owens Realty Mortgage, Inc.
ORN : Orion Marine Group Inc
OSIR : Osiris Therapeutics, Inc.
OSIS : OSI Systems, Inc.
OSK : Oshkosh Corporation
OSTK : Overstock.com, Inc.
OSUR : OraSure Technologies, Inc.
OTTR : Otter Tail Corporation
OUTR : (OUTR) Prices, Dividends, Splits and Trading Volume
OVAS : Ovascience Inc.
OVTI : OmniVision Technologies, Inc.
OWW : Orbitz Worldwide, Inc.
OXFD : (OXFD) Prices, Dividends, Splits and Trading Volume
OXM : Oxford Industries, Inc.
OXY : Occidental Petroleum Corporation
OZRK : Bank of the Ozarks
O : Realty Income Corporation
PACB : Pacific Biosciences of California, Inc.
PACW : PacWest Bancorp
PAG : Penske Automotive Group, Inc.
PAHC : Phibro Animal Health Corporation
PANW : Palo Alto Networks, Inc.
PATK : Patrick Industries, Inc.
PAYC : Paycom Software, Inc.
PAYX : Paychex, Inc.
PAY : Verifone Systems, Inc.
PBCT : People's United Financial, Inc.
PBF : PBF Energy Inc.
PBH : Prestige Brand Holdings, Inc.
PBI : Pitney Bowes Inc.
PBPB : Potbelly Corporation
PBYI : Puma Biotechnology Inc
PBY : Pep Boys-Manny, Moe & Jack
PB : Prosperity Bancshares, Inc.
PCAR : PACCAR Inc.
PCBK : Pacific Continental Corporation
PCCC : PC Connection, Inc.
PCG : Pacific Gas & Electric Co.
PCH : Potlatch Corporation
PCLN : The Priceline Group Inc.
PCL : Plum Creek Timber Company, Inc.
PCO : Pendrell Corporation
PCP : Precision Castparts Corporation
PCRX : Pacira Pharmaceuticals, Inc.
PCTI : PC-Tel, Inc.
PCTY : Paylocity Holding Corporation
PCYG : (PCYG) Prices, Dividends, Splits and Trading Volume
PCYO : Pure Cycle Corporation
PDCE : PDC Energy, Inc.
PDCO : Patterson Companies, Inc.
PDFS : PDF Solutions, Inc.
PDLI : PDL BioPharma, Inc.
PDM : Piedmont Office Realty Trust, Inc.
PEBO : Peoples Bancorp Inc.
PEB : Pebblebrook Hotel Trust
PEGA : Pegasystems Inc.
PEGI : (PEGI) Prices, Dividends, Splits and Trading Volume
PEG : Public Service Enterprise Group Incorporated
PEIX : (PEIX) Prices, Dividends, Splits and Trading Volume
PEI : Pennsylvania Real Estate Investment Trust
PENN : Penn National Gaming, Inc.
PEP : Pepsico, Inc.
PERI : Perion Network Ltd
PERY : Perry Ellis International Inc.
PES : Pioneer Energy Services Corp.
PETS : PetMed Express, Inc.
PETX : Aratana Therapeutics, Inc.
PE : Parsley Energy, Inc.
PFBC : Preferred Bank
PFE : Pfizer, Inc.
PFG : Principal Financial Group Inc
PFIE : Profire Energy, Inc.
PFIS : Peoples Financial Services Corporation
PFLT : PennantPark Floating Rate Capital Ltd.
PFMT : Performant Financial Corporation
PFPT : Proofpoint, Inc.
PFSI : PennyMac Financial Services, Inc.
PFS : Provident Financial Services, Inc
PF : Pinnacle Foods, Inc.
PGC : Peapack-Gladstone Financial Corporation
PGEM : Ply Gem Holdings, Inc.
PGI : Premiere Global Services, Inc.
PGNX : Progenics Pharmaceuticals Inc.
PGR : Progressive Corporation
PGTI : PGT, Inc.
PG : Procter & Gamble Company
PHH : PHH Corp
PHIIK : PHI, Inc.
PHMD : PhotoMedex, Inc.
PHM : PulteGroup, Inc.
PHX : Panhandle Royalty Company
PH : Parker-Hannifin Corporation
PICO : PICO Holdings Inc.
PII : Polaris Industries Inc.
PIR : Pier 1 Imports, Inc.
PJC : Piper Jaffray Companies
PKD : Parker Drilling Company
PKE : Park Electrochemical Corporation
PKG : Packaging Corporation of America
PKI : PerkinElmer, Inc.
PKOH : Park-Ohio Holdings Corp.
PKY : Parkway Properties, Inc.
PLAB : Photronics, Inc.
PLCE : The Children's Place Retail Stores, Inc.
PLCM : Polycom, Inc.
PLD : ProLogis, Inc.
PLKI : Popeyes Louisiana Kitchen, Inc.
PLL : Pall Corporation
PLMT : Palmetto Bancshares, Inc.
PLOW : Douglas Dynamics, Inc.
PLPC : Preformed Line Products Company
PLPM : Planet Payment, Inc.
PLT : Plantronics, Inc.
PLUG : Plug Power, Inc.
PLUS : ePlus inc.
PLXS : Plexus Corp.
PMCS : PMC - Sierra, Inc.
PMC : Pharmerica Corporation
PMFG : PMFG, Inc.
PMT : PennyMac Mortgage Investment Trust
PM : Philip Morris International Inc
PNC : PNC Financial Services Group, Inc.
PNFP : Pinnacle Financial Partners, Inc.
PNK : Pinnacle Entertainment, Inc.
PNM : PNM Resources, Inc.
PNNT : PennantPark Investment Corporation
PNRA : Panera Bread Company
PNR : Pentair plc.
PNW : Pinnacle West Capital Corporation
PNX : Phoenix Companies, Inc.
PNY : Piedmont Natural Gas Company, Inc.
PODD : Insulet Corporation
POL : PolyOne Corporation
POM : PEPCO Holdings, Inc.
POOL : Pool Corporation
POR : Portland General Electric Company
POST : Post Holdings, Inc.
POWI : Power Integrations, Inc.
POWL : Powell Industries, Inc.
POWR : PowerSecure International, Inc
POZN : Pozen, Inc.
PPBI : Pacific Premier Bancorp Inc
PPC : Pilgrim's Pride Corporation
PPG : PPG Industries, Inc.
PPHM : Peregrine Pharmaceuticals Inc.
PPL : PPL Corporation
PPO : Polypore International Inc
PPS : Post Properties, Inc.
PQ : Petroquest Energy Inc
PRAA : Portfolio Recovery Associates, Inc.
PRA : ProAssurance Corporation
PRE : PartnerRe Ltd.
PRFT : Perficient, Inc.
PRGO : Perrigo Company
PRGS : Progress Software Corporation
PRGX : PRGX Global, Inc.
PRIM : Primoris Services Corporation
PRI : Primerica, Inc.
PRKR : ParkerVision, Inc.
PRK : Park National Corporation
PRLB : Proto Labs, Inc.
PROV : Provident Financial Holdings, Inc.
PRO : PROS Holdings, Inc.
PRSC : The Providence Service Corporation
PRTA : Prothena Corporation plc
PRU : Prudential Financial, Inc.
PRXL : PAREXEL International Corporation
PSA : Public Storage
PSB : PS Business Parks, Inc.
PSEC : Prospect Capital Corporation
PSEM : Pericom Semiconductor Corporation
PSIX : Power Solutions International, Inc.
PSMT : PriceSmart, Inc.
PSTB : Park Sterling Corporation
PSUN : Pacific Sunwear of California, Inc.
PSX : Phillips 66
PTCT : PTC Therapeutics, Inc.
PTEN : Patterson-UTI Energy, Inc.
PTIE : (PTIE) Prices, Dividends, Splits and Trading Volume
PTLA : Portola Pharmaceuticals, Inc.
PTSI : (PTSI) Prices, Dividends, Splits and Trading Volume
PTX : Pernix Therapeutics Holdings, Inc.
PVA : Penn Virginia Corporation
PVH : PVH Corp.
PVTB : PrivateBancorp, Inc.
PWOD : Penns Woods Bancorp, Inc.
PWR : Quanta Services, Inc.
PXD : Pioneer Natural Resources Company
PX : Praxair, Inc.
PZG : Paramount Gold and Silver Corp.
PZN : Pzena Investment Management Inc
PZZA : Papa John'S International, Inc.
P : Pandora Media, Inc.
QADA : QAD Inc.
QCOM : QUALCOMM Incorporated
QDEL : Quidel Corporation
QGEN : Qiagen N.V.
QLGC : QLogic Corporation
QLIK : Qlik Technologies Inc.
QLTY : Quality Distribution, Inc.
QLYS : Qualys, Inc.
QNST : QuinStreet, Inc.
QRHC : Quest Resource Holding Corporation.
QRVO : Untitled Dataset 2015-06-11 21:47:07
QSII : Quality Systems, Inc.
QTM : Quantum Corporation
QTS : QTS Realty Trust, Inc.
QTWO : Q2 Holdings, Inc.
QUAD : Quad Graphics, Inc
QUIK : QuickLogic Corporation
Q : Quintiles Transitional Holdings Inc.
RAD : Rite Aid Corporation
RAIL : Freightcar America, Inc.
RAI : Reynolds American Inc
RARE : Ultragenyx Pharmaceutical Inc.
RAS : RAIT Financial Trust
RATE : Bankrate, Inc.
RAVN : Raven Industries, Inc.
RAX : Rackspace Hosting, Inc
RBCAA : Republic Bancorp, Inc.
RBCN : Rubicon Technology, Inc.
RBC : Regal Beloit Corporation
RCAP : RCS CAPITAL CORPORATION
RCII : Rent-A-Center Inc.
RCL : Royal Caribbean Cruises Ltd.
RCPT : Receptos, Inc.
RDEN : Elizabeth Arden, Inc.
RDI : Reading International Inc
RDNT : RadNet, Inc.
RDN : Radian Group Inc.
RECN : Resources Connection, Inc.
REGI : Renewable Energy Group, Inc.
REGN : Regeneron Pharmaceuticals, Inc.
REG : (REG) Prices, Dividends, Splits and Trading Volume
REIS : Reis, Inc
REI : Ring Energy, Inc.
RELL : Richardson Electronics, Ltd.
REMY : Remy International, Inc.
RENT : Rentrak Corporation
REN : Resolute Energy Corporation
RESI : Altisource Residential Corporation
RES : RPC, Inc.
REV : Revlon, Inc.
REXI : Resource America, Inc.
REXR : Rexford Industrial Realty, Inc.
REXX : Rex Energy Corporation
REX : REX American Resources Corporation
RE : Everest Re Group, Ltd.
RFP : Resolute Forest Products Inc.
RF : Regions Financial Corporation
RGA : Reinsurance Group of America, Incorporated
RGC : Regal Entertainment Group
RGEN : Repligen Corporation
RGLD : Royal Gold, Inc.
RGLS : Regulus Therapeutics Inc.
RGR : Sturm, Ruger & Company, Inc.
RGS : Regis Corporation
RHI : Robert Half International Inc.
RHP : Ryman Hospitality Properties, Inc.
RHT : Red Hat, Inc.
RH : Restoration Hardware Holdings Inc.
RIGL : Rigel Pharmaceuticals, Inc.
RIG : Transocean Ltd.
RJET : Republic Airways Holdings, Inc.
RJF : Raymond James Financial, Inc.
RKUS : Ruckus Wireless, Inc.
RLD : RealD Inc
RLGY : Realogy Holdings Corp.
RLI : RLI Corp.
RLJ : RLJ Lodging Trust
RLOC : ReachLocal, Inc.
RLYP : Relypsa, Inc.
RL : Ralph Lauren Corporation
RMAX : RE/MAX Holdings, Inc.
RMBS : Rambus, Inc.
RMD : ResMed Inc.
RMTI : Rockwell Medical, Inc.
RM : Regional Management Corp.
RNDY : Roundy's, Inc.
RNET : RigNet, Inc.
RNG : Ringcentral, Inc.
RNR : RenaissanceRe Holdings Ltd.
RNST : Renasant Corporation
RNWK : RealNetworks, Inc.
ROCK : Gibraltar Industries, Inc.
ROG : Rogers Corporation
ROIAK : Radio One, Inc.
ROIC : Retail Opportunity Investments Corp.
ROK : Rockwell Automation, Inc.
ROLL : RBC Bearings Incorporated
ROL : Rollins, Inc.
ROP : Roper Industries, Inc.
ROSE : Rosetta Resources Inc.
ROST : Ross Stores, Inc.
ROVI : Rovi Corporation
RPAI : (RPAI) Prices, Dividends, Splits and Trading Volume
RPM : RPM International Inc.
RPRX : Repros Therapeutics Inc.
RPTP : Raptor Pharmaceutical Corp.
RPT : Ramco-Gershenson Properties Trust
RPXC : RPX Corporation
RP : RealPage, Inc.
RRC : Range Resources Corporation
RRD : R.R. Donnelley & Sons Company
RRGB : Red Robin Gourmet Burgers, Inc.
RRTS : Roadrunner Transportation Systems, Inc
RSE : Rouse Properties, Inc.
RSG : Republic Services, Inc.
RSO : Resource Capital Corp.
RSPP : RSP Permian, Inc.
RSTI : Rofin-Sinar Technologies, Inc.
RST : Rosetta Stone
RSYS : RadiSys Corporation
RS : Reliance Steel & Aluminum Co.
RTEC : Rudolph Technologies, Inc.
RTIX : RTI Surgical, Inc.
RTI : RTI International Metals, Inc.
RTK : Rentech, Inc.
RTN : Raytheon Company
RTRX : Retrophin, Inc.
RT : Ruby Tuesday, Inc.
RUBI : The Rubicon Project, Inc.
RUSHA : Rush Enterprises, Inc.
RUTH : Ruth's Hospitality Group, Inc.
RVLT : Revolution Lighting Technologies, Inc.
RVNC : Revance Therapeutics, Inc.
RWT : Redwood Trust, Inc.
RXN : Rexnord Corporation
RYL : Ryland Group, Inc.
RYN : Rayonier Inc.
R : Ryder System, Inc.
SAAS : inContact, Inc.
SAFM : Sanderson Farms, Inc.
SAFT : Safety Insurance Group, Inc.
SAH : Sonic Automotive, Inc.
SAIA : Saia, Inc.
SAIC : SCIENCE APPLICATIONS INTERNATIONAL CORPORATION
SALE : RetailMeNot, Inc.
SALM : Salem Communications Corporation
SALT : Scorpio Bulkers Inc.
SAMG : Silvercrest Asset Management Group Inc.
SAM : Boston Beer Company, Inc.
SANM : Sanmina Corporation
SASR : Sandy Spring Bancorp, Inc.
SATS : EchoStar Corporation
SAVE : Spirit Airlines, Inc.
SBAC : SBA Communications Corporation
SBCF : Seacoast Banking Corporation of Florida
SBGI : Sinclair Broadcast Group, Inc.
SBH : Sally Beauty Holdings, Inc.
SBNY : Signature Bank
SBRA : Sabra Healthcare REIT, Inc.
SBSI : Southside Bancshares, Inc.
SBUX : Starbucks Corporation
SBY : Silver Bay Realty Trust Corp.
SB : Safe Bulkers, Inc
SCAI : Surgical Care Affiliates, Inc.
SCCO : Southern Copper Corporation
SCG : Scana Corporation
SCHL : Scholastic Corporation
SCHN : Schnitzer Steel Industries, Inc.
SCHW : The Charles Schwab Corporation
SCI : Service Corporation International
SCLN : SciClone Pharmaceuticals, Inc.
SCL : Stepan Company
SCMP : Sucampo Pharmaceuticals, Inc.
SCM : Stellus Capital Investment Corporation
SCOR : comScore, Inc.
SCSC : ScanSource, Inc.
SCSS : Select Comfort Corporation
SCS : Steelcase Inc.
SCTY : SolarCity Corporation
SCVL : Shoe Carnival, Inc.
SDRL : Seadrill Limited
SD : Sandridge Energy Inc.
SEAC : SeaChange International, Inc.
SEAS : SeaWorld Entertainment, Inc.
SEB : Seaboard Corporation
SEE : Sealed Air Corporation
SEIC : SEI Investments Company
SEMG : Semgroup Corporation
SEM : Select Medical Holdings Corporation
SENEA : Seneca Foods Corp.
SE : Spectra Energy Corp
SFBS : ServisFirst Bancshares, Inc.
SFE : Safeguard Scientifics, Inc.
SFG : StanCorp Financial Group, Inc.
SFLY : Shutterfly, Inc.
SFL : Ship Finance International Limited
SFNC : Simmons First National Corporation
SFXE : SFX Entertainment, Inc.
SFY : Swift Energy Company
SF : Stifel Financial Corporation
SGA : Saga Communications, Inc.
SGBK : Stonegate Bank
SGEN : Seattle Genetics, Inc.
SGI : Silicon Graphics International Corp
SGMO : Sangamo BioSciences, Inc.
SGMS : Scientific Games Corp
SGM : Stonegate Mortgage Corporation
SGNT : Sagent Pharmaceuticals, Inc.
SGYP : Synergy Pharmaceuticals, Inc.
SGY : Stone Energy Corporation
SHEN : Shenandoah Telecommunications Co
SHLD : Sears Holdings Corporation
SHLM : A. Schulman, Inc.
SHLO : Shiloh Industries, Inc.
SHOO : Steven Madden, Ltd.
SHOR : ShoreTel, Inc.
SHOS : Sears Hometown and Outlet Stores, Inc.
SHO : Sunstone Hotel Investors, Inc.
SHW : Sherwin-Williams Company
SIAL : Sigma-Aldrich Corporation
SIF : SIFCO Industries, Inc.
SIGI : Selective Insurance Group, Inc.
SIGM : Sigma Designs, Inc.
SIG : Signet Jewelers Limited
SIRI : Sirius XM Holdings Inc.
SIRO : Sirona Dental Systems, Inc.
SIR : Select Income REIT
SIVB : SVB Financial Group
SIX : Six Flags Entertainment Corporation New
SJI : South Jersey Industries, Inc.
SJM : J.M. Smucker Company
SJW : SJW Corporation
SKT : Tanger Factory Outlet Centers, Inc.
SKUL : Skullcandy, Inc.
SKX : Skechers U.S.A., Inc.
SKYW : SkyWest, Inc.
SLAB : Silicon Laboratories, Inc.
SLB : Schlumberger N.V.
SLCA : U.S. Silica Holdings, Inc.
SLGN : Silgan Holdings Inc.
SLG : SL Green Realty Corporation
SLH : Solera Holdings, Inc.
SLRC : Solar Capital Ltd.
SMCI : Super Micro Computer, Inc.
SMG : Scotts Miracle-Gro Company
SMP : Standard Motor Products, Inc.
SMRT : Stein Mart, Inc.
SMTC : Semtech Corporation
SM : SM Energy Company
SNAK : Inventure Foods, Inc.
SNA : Snap-On Incorporated
SNBC : Sun Bancorp, Inc.
SNCR : Synchronoss Technologies, Inc.
SNDK : SanDisk Corporation
SNHY : Sun Hydraulics Corporation
SNH : Senior Housing Properties Trust
SNI : Scripps Networks Interactive, Inc
SNMX : Senomyx, Inc.
SNOW : Intrawest Resorts Holdings, Inc.
SNPS : Synopsys, Inc.
SNSS : Sunesis Pharmaceuticals, Inc.
SNTA : Synta Pharmaceuticals Corp.
SNV : Synovus Financial Corp.
SNX : Synnex Corporation
SN : Sanchez Energy Corporation
SONC : Sonic Corp.
SONS : Sonus Networks, Inc.
SON : Sonoco Products Company
SO : Southern Company
SPAR : Spartan Motors, Inc.
SPA : Sparton Corporation
SPB : Spectrum Brands Holdings, Inc.
SPDC : Speed Commerce, Inc.
SPF : Standard Pacific Corp
SPG : Simon Property Group, Inc.
SPLK : Splunk Inc.
SPLS : Staples, Inc.
SPNC : The Spectranetics Corporation
SPNS : Sapiens International Corporation N.V.
SPN : Superior Energy Services, Inc.
SPPI : Spectrum Pharmaceuticals, Inc.
SPRT : support.com, Inc.
SPR : Spirit Aerosystems Holdings, Inc.
SPSC : SPS Commerce, Inc.
SPTN : Spartan Stores, Inc.
SPWH : Sportsman's Warehouse Holdings, Inc.
SPWR : SunPower Corporation
SPW : SPX Corporation
SP : SP Plus Corporation
SQBG : Sequential Brands Group, Inc.
SQBK : Square 1 Financial, Inc.
SQI : SciQuest, Inc.
SQNM : Sequenom, Inc.
SRCE : 1st Source Corporation
SRCL : Stericycle, Inc.
SRDX : SurModics, Inc.
SREV : ServiceSource International, Inc.
SRE : Sempra Energy
SRI : Stoneridge, Inc.
SRPT : Sarepta Therapeutics, Inc.
SSD : Simpson Manufacturing Company, Inc.
SSI : Stage Stores, Inc.
SSNC : SS&C Technologies Holdings, Inc.
SSNI : Silver Spring Networks, Inc.
SSP : E.W. Scripps Company
SSS : Sovran Self Storage, Inc.
SSTK : Shutterstock, Inc.
SSYS : Stratasys, Ltd.
STAA : STAAR Surgical Company
STAG : Stag Industrial, Inc.
STAR : iStar Financial Inc.
STBA : S&T Bancorp, Inc.
STBZ : State Bank Financial Corporation.
STCK : Stock Building Supply Holdings, Inc.
STC : Stewart Information Services Corporation
STE : STERIS Corporation
STFC : State Auto Financial Corporation
STI : SunTrust Banks, Inc.
STJ : St. Jude Medical, Inc.
STLD : Steel Dynamics, Inc.
STL : Sterling Bancorp
STML : Stemline Therapeutics, Inc.
STMP : Stamps.com Inc.
STNG : Scorpio Tankers Inc.
STNR : Steiner Leisure Limited
STRA : Strayer Education, Inc.
STRL : Sterling Construction Company Inc
STRT : Strattec Security Corporation
STRZA : Starz
STR : Questar Corporation
STT : State Street Corporation
STWD : STARWOOD PROPERTY TRUST, INC.
STX : Seagate Technology.
STZ : Constellation Brands Inc
SUBK : Suffolk Bancorp
SUI : Sun Communities, Inc.
SUNE : SunEdison, Inc.
SUNS : Solar Senior Capital Ltd.
SUN : Sunoco LP
SUPN : Supernus Pharmaceuticals, Inc.
SUP : Superior Industries International, Inc.
SUSQ : Susquehanna Bancshares, Inc.
SVU : SuperValu Inc.
SVVC : Firsthand Technology Value Fund, Inc.
SWAY : Starwood Waypoint Residential Trust
SWC : Stillwater Mining Company
SWFT : Swift Transportation Company
SWHC : Smith & Wesson Holding Corporation
SWI : Solarwinds, Inc.
SWKS : Skyworks Solutions, Inc.
SWK : Stanley Black & Decker, Inc.
SWM : Schweitzer-Mauduit International, Inc.
SWN : Southwestern Energy Company
SWSH : Swisher Hygiene, Inc.
SWX : Southwest Gas Corporation
SXC : SunCoke Energy, Inc.
SXI : Standex International Corporation
SXT : Sensient Technologies Corporation
SYA : Symetra Financial Corporation
SYBT : Stock Yards Bancorp, Inc.
SYKE : Sykes Enterprises, Incorporated
SYK : Stryker Corporation
SYMC : Symantec Corporation
SYNA : Synaptics Incorporated
SYNT : Syntel, Inc.
SYRG : Synergy Resources Corporation
SYUT : Synutra International, Inc.
SYX : Systemax Inc.
SYY : Sysco Corporation
SZMK : Sizmek Inc.
SZYM : Solazyme, Inc.
S : Sprint Corporation
TAHO : Tahoe Resources, Inc.
TAL : TAL International Group, Inc.
TAP : Molson Coors Brewing  Company
TASR : TASER International, Inc.
TAST : Carrols Restaurant Group, Inc.
TAT : Transatlantic Petroleum Ltd
TAXI : Medallion Financial Corp.
TAX : JTH Holding Inc. D/B/A Liberty Tax Service
TBBK : The Bancorp, Inc.
TBI : TrueBlue, Inc.
TBNK : Territorial Bancorp Inc.
TBPH : Theravance Biopharma, Inc.
TCAP : Triangle Capital Corporation
TCBI : Texas Capital Bancshares, Inc.
TCBK : TriCo Bancshares
TCB : TCF Financial Corporation
TCO : Taubman Centers, Inc.
TCPC : TCP Capital Corp.
TCRD : THL Credit, Inc.
TCS : Container Store
TDC : Teradata Corporation
TDG : Transdigm Group Incorporated
TDS : Telephone and Data Systems, Inc.
TDW : Tidewater Inc.
TDY : Teledyne Technologies Incorporated
TEAR : TearLab Corporation
TECD : Tech Data Corporation
TECH : Techne Corporation
TEL : TE Connectivity Ltd.
TEN : Tenneco Inc.
TER : Teradyne, Inc.
TESO : Tesco Corporation
TESS : TESSCO Technologies Incorporated
TEX : Terex Corporation
TE : TECO Energy, Inc.
TFM : The Fresh Market, Inc.
TFSL : TFS Financial Corporation
TFX : Teleflex Incorporated
TGH : Textainer Group Holdings Limited
TGI : Triumph Group, Inc.
TGNA : Untitled Dataset 2015-06-29 21:46:27
TGTX : TG Therapeutics, Inc.
TGT : Target Corporation
TG : Tredegar Corporation
THC : Tenet Healthcare Corporation
THFF : First Financial Corporation Indiana
THG : The Hanover Insurance Group, Inc.
THLD : Threshold Pharmaceuticals, Inc.
THOR : Thoratec Corporation
THO : Thor Industries, Inc.
THRM : Gentherm Inc
THRX : Theravance, Inc.
THR : Thermon Group Holdings, Inc.
THS : Treehouse Foods, Inc.
TICC : TICC Capital Corp.
TIF : Tiffany & Co.
TILE : Interface, Inc.
TIME : Time Inc.
TIPT : Tiptree Financial Inc.
TISI : Team, Inc.
TIS : Orchids Paper Products Company
TITN : Titan Machinery Inc.
TIVO : TiVo Inc.
TJX : TJX Companies, Inc.
TKR : Timken Company
TK : Teekay Corporation
TLMR : Talmer Bancorp, Inc.
TLYS : Tilly's, Inc.
TMHC : Taylor Morrison Home Corporation
TMH : Team Health Holdings, Inc.
TMK : Torchmark Corporation
TMO : Thermo Fisher Scientific Inc
TMP : Tompkins Financial Corporation
TMUS : T-Mobile US, Inc.
TNAV : TeleNav, Inc.
TNC : Tennant Company
TNDM : Tandem Diabetes Care, Inc.
TNET : TriNet Group, Inc.
TNGO : Tangoe, Inc.
TNK : Teekay Tankers Ltd.
TOL : Toll Brothers Inc.
TOWN : Towne Bank
TOWR : Tower International, Inc.
TPC : Tutor Perini Corporation
TPH : Tri Pointe Homes, Inc.
TPLM : Triangle Petroleum Corporation
TPRE : Third Point Reinsurance Ltd.
TPX : Tempur Sealy International, Inc.
TRAK : Dealertrack Technologies, Inc.
TRC : Tejon Ranch Co
TREC : Trecora Resources
TREE : Tree.com, Inc.
TREX : Trex Company, Inc.
TRGP : Targa Resources, Inc.
TRGT : Targacept, Inc.
TRIP : TripAdvisor, Inc.
TRIV : TriVascular Technologies, Inc.
TRI : Thomson Reuters Corp
TRK : Speedway Motorsports, Inc.
TRMB : Trimble Navigation Limited
TRMK : Trustmark Corporation
TRMR : Tremor Video, Inc.
TRNO : Terreno Realty Corporation
TRNX : Tornier N.V.
TRN : Trinity Industries, Inc.
TROW : T. Rowe Price Group, Inc.
TROX : Tronox Limited
TRR : TRC Companies, Inc.
TRST : TrustCo Bank Corp NY
TRS : TriMas Corporation
TRUE : TrueCar, Inc.
TRV : The Travelers Companies, Inc.
TRXC : TransEnterix, Inc.
TR : Tootsie Roll Industries, Inc.
TSCO : Tractor Supply Company
TSC : TriState Capital Holdings, Inc.
TSLA : Tesla Motors, Inc.
TSN : Tyson Foods, Inc.
TSO : Tesoro Corporation
TSRA : Tessera Technologies, Inc.
TSRE : Trade Street Residential, Inc.
TSRO : TESARO, Inc.
TSS : Total System Services, Inc.
TSYS : TeleCommunication Systems, Inc.
TTC : Toro Company
TTEC : TeleTech Holdings, Inc.
TTEK : Tetra Tech, Inc.
TTGT : TechTarget, Inc.
TTI : Tetra Technologies, Inc.
TTMI : TTM Technologies, Inc.
TTPH : Tetraphase Pharmaceuticals, Inc.
TTS : Tile Shop Hldgs, Inc.
TTWO : Take-Two Interactive Software, Inc.
TUES : Tuesday Morning Corp.
TUMI : Tumi Holdings, Inc.
TUP : Tupperware Brands Corporation
TWC : Time Warner Cable Inc
TWER : Towerstream Corporation
TWIN : Twin Disc, Incorporated
TWI : Titan International, Inc.
TWMC : Trans World Entertainment Corp.
TWOU : 2U, Inc.
TWO : Two Harbors Investments Corp
TWTR : Twitter, Inc.
TWX : Time Warner Inc.
TW : Towers Watson & Co
TXMD : TherapeuticsMD, Inc.
TXN : Texas Instruments Incorporated
TXRH : Texas Roadhouse, Inc.
TXTR : Textura Corporation
TXT : Textron Inc.
TYC : Tyco International, Ltd.
TYL : Tyler Technologies, Inc.
TYPE : Monotype Imaging Holdings Inc.
TZOO : Travelzoo Inc.
T : AT&T Inc.
UACL : Universal Truckload Services, Inc.
UAL : United Continental Holdings, Inc.
UAM : Universal American Corp.
UA : Under Armour, Inc.
UBA : Urstadt Biddle Properties Inc.
UBNK : United Financial Bancorp, Inc.
UBNT : Ubiquiti Networks, Inc.
UBSH : Union Bankshares Corporation
UBSI : United Bankshares, Inc.
UCBI : United Community Banks, Inc.
UCFC : United Community Financial Corp.
UCP : UCP, Inc.
UCTT : Ultra Clean Holdings, Inc.
UDR : United Dominion Realty Trust, Inc.
UEC : Uranium Energy Corp.
UEIC : Universal Electronics Inc.
UFCS : United Fire Group, Inc
UFI : Unifi, Inc.
UFPI : Universal Forest Products, Inc.
UFPT : UFP Technologies, Inc.
UFS : Domtar Corporation
UGI : UGI Corporation
UHAL : Amerco
UHS : Universal Health Services, Inc.
UHT : Universal Health Realty Income Trust
UIHC : United Insurance Holdings Corp.
UIL : UIL Holdings Corporation
UIS : Unisys Corporation
ULTA : Ulta Salon, Cosmetics & Fragrance, Inc.
ULTI : The Ultimate Software Group, Inc.
ULTR : Ultrapetrol
UMBF : UMB Financial Corporation
UMH : UMH Properties, Inc.
UMPQ : Umpqua Holdings Corporation
UNFI : United Natural Foods, Inc.
UNF : Unifirst Corporation
UNH : UnitedHealth Group Incorporated
UNIS : Unilife Corporation
UNM : Unum Group
UNP : Union Pacific Corporation
UNTD : United Online, Inc.
UNT : Unit Corporation
UNXL : Uni-Pixel, Inc.
UPIP : Unwired Planet, Inc.
UPL : Ultra Petroleum Corp.
UPS : United Parcel Service, Inc.
URBN : Urban Outfitters, Inc.
URG : Ur Energy Inc
URI : United Rentals, Inc.
USAK : USA Truck, Inc.
USAP : Universal Stainless & Alloy Products, Inc.
USB : U.S. Bancorp
USCR : U S Concrete, Inc.
USG : USG Corporation
USLM : United States Lime & Minerals, Inc.
USMD : USMD Holdings, Inc.
USM : United States Cellular Corporation
USNA : USANA Health Sciences, Inc.
USPH : U.S. Physical Therapy, Inc.
UTEK : Ultratech, Inc.
UTHR : United Therapeutics Corporation
UTIW : UTi Worldwide Inc.
UTI : Universal Technical Institute Inc
UTL : UNITIL Corporation
UTMD : Utah Medical Products, Inc.
UTX : United Technologies Corporation
UVE : UNIVERSAL INSURANCE HOLDINGS INC
UVSP : Univest Corporation of Pennsylvania
UVV : Universal Corporation
VAC : Marriot Vacations Worldwide Corporation
VAL : Valspar Corporation
VAR : Varian Medical Systems, Inc.
VASC : Vascular Solutions, Inc.
VCRA : Vocera Communications, Inc.
VCYT : Veracyte, Inc.
VC : Visteon Corporation
VDSI : VASCO Data Security International, Inc.
VECO : Veeco Instruments Inc.
VFC : V.F. Corporation
VGR : Vector Group Ltd.
VG : Vonage Holdings Corp.
VHC : VirnetX Holding Corp
VIAB : Viacom Inc.
VICL : Vical Incorporated
VICR : Vicor Corporation
VIVO : Meridian Bioscience Inc.
VLGEA : Village Super Market, Inc.
VLO : Valero Energy Corporation
VLY : Valley National Bancorp
VMC : Vulcan Materials Company
VMEM : Violin Memory, Inc.
VMI : Valmont Industries, Inc.
VMW : Vmware, Inc.
VNCE : Vince Holding Corp.
VNDA : Vanda Pharmaceuticals Inc.
VNO : Vornado Realty Trust
VNTV : Vantiv, Inc.
VOD : Vodafone Group Plc
VOXX : VOXX International Corporation
VOYA : Voya Financial, Inc.
VPG : Vishay Precision Group, Inc.
VRA : Vera Bradley, Inc.
VRNG : Vringo, Inc.
VRNS : Varonis Systems, Inc.
VRNT : Verint Systems Inc.
VRSK : Verisk Analytics, Inc.
VRSN : VeriSign, Inc.
VRTS : Virtus Investment Partners, Inc.
VRTU : Virtusa Corporation
VRTX : Vertex Pharmaceuticals Incorporated
VR : Validus Holdings, Ltd.
VSAR : Versartis, Inc.
VSAT : ViaSat, Inc.
VSEC : VSE Corporation
VSH : Vishay Intertechnology, Inc.
VSI : Vitamin Shoppe, Inc
VSTM : Verastem, Inc.
VTG : Vantage Drilling Company
VTL : Vital Therapies, Inc.
VTNR : Vertex Energy, Inc
VTR : Ventas, Inc.
VVC : Vectren Corporation
VVI : Viad Corp
VVUS : VIVUS, Inc.
VZ : Verizon Communications Inc.
V : Visa Inc.
WABC : Westamerica Bancorporation
WAB : Westinghouse Air Brake Technologies Corporation
WAC : Walter Investment Management Corp.
WAFD : Washington Federal, Inc.
WAGE : WageWorks, Inc.
WAIR : Wesco Aircraft Holdings, Inc.
WAL : Western Alliance Bancorporation
WASH : Washington Trust Bancorp, Inc.
WAT : Waters Corporation
WBA : Untitled Dataset 2015-01-05 22:31:42
WBC : Wabco Holdings Inc.
WBMD : WebMD Health Corp
WBS : Webster Financial Corporation
WCC : WESCO International, Inc.
WCG : WellCare Health Plans, Inc.
WCIC : WCI Communities, Inc.
WCN : Waste Connections, Inc.
WDAY : Workday, Inc.
WDC : Western Digital Corporation
WDFC : WD-40 Company
WDR : Waddell & Reed Financial, Inc.
WD : Walker & Dunlop, Inc.
WEC : Wisconsin Energy Corporation
WEN : Wendy's Company
WERN : Werner Enterprises, Inc.
WETF : WisdomTree Investments, Inc.
WEX : WEX Inc.
WEYS : Weyco Group, Inc.
WFC : Wells Fargo & Company
WFD : Westfield Financial, Inc.
WFM : Whole Foods Market, Inc.
WGL : WGL Holdings Inc
WGO : Winnebago Industries, Inc.
WG : Willbros Group, Inc.
WHF : WhiteHorse Finance, Inc.
WHG : Westwood Holdings Group Inc
WHR : Whirlpool Corporation
WIBC : Wilshire Bancorp, Inc.
WIFI : Boingo Wireless, Inc.
WINA : Winmark Corporation
WIRE : Encore Wire Corporation
WIX : Wix.com Ltd.
WLB : Westmoreland Coal Company
WLH : Lyon William Homes
WLK : Westlake Chemical Corporation
WLL : Whiting Petroleum Corporation
WMAR : West Marine, Inc.
WMB : Williams Companies, Inc.
WMC : Western Asset Mortgage Capital Corporation
WMGI : Wright Medical Group, Inc.
WMK : Weis Markets, Inc.
WMT : Wal-Mart Stores, Inc.
WM : Waste Management, Inc.
WNC : Wabash National Corporation
WNR : Western Refining, Inc.
WOOF : VCA Antech, Inc.
WOR : Worthington Industries, Inc.
WPP : Wausau Paper Corp.
WPX : WPX Energy, Inc.
WRB : W.R. Berkley Corporation
WRES : Warren Resources, Inc.
WRE : Washington Real Estate Investment Trust
WRI : Weingarten Realty Investors
WRLD : World Acceptance Corporation
WR : Westar Energy, Inc.
WSBC : WesBanco, Inc.
WSBF : Waterstone Financial, Inc.
WSFS : WSFS Financial Corporation
WSM : Williams-Sonoma, Inc.
WSO : Watsco, Inc.
WSR : Whitestone REIT
WSTC : West Corporation
WSTL : Westell Technologies, Inc.
WST : West Pharmaceutical Services, Inc.
WTBA : West Bancorporation
WTFC : Wintrust Financial Corporation
WTI : W&T Offshore, Inc.
WTM : White Mountains Insurance Group, Ltd.
WTR : Aqua America, Inc.
WTS : Watts Water Technologies, Inc.
WTW : Weight Watchers International Inc
WU : Western Union Company
WWAV : Whitewave Foods Company
WWD : Woodward, Inc.
WWE : World Wrestling Entertainment, Inc.
WWWW : Web.com Group, Inc.
WWW : Wolverine World Wide, Inc.
WYNN : Wynn Resorts, Limited
WYN : Wyndham Worldwide Corp
WY : Weyerhaeuser Company
XCO : EXCO Resources NL
XCRA : Xcerra Corporation
XEC : Cimarex Energy Co
XEL : Xcel Energy Inc.
XLNX : Xilinx, Inc.
XLRN : Acceleron Pharma Inc.
XL : XL Group plc
XNCR : Xencor, Inc.
XNPT : XenoPort, Inc.
XOMA : XOMA Corporation
XOM : Exxon Mobil Corporation
XONE : The ExOne Company
XON : Intrexon Corporation
XOOM : Xoom Corporation
XOXO : XO Group, Inc.
XPO : XPO Logistics, Inc.
XRAY : DENTSPLY International Inc.
XRM : Xerium Technologies, Inc.
XRX : Xerox Corporation
XXIA : Ixia
XXII : 22nd Century Group, Inc
XYL : Xylem Inc.
X : United States Steel Corporation
YDKN : Yadkin Financial Corporation
YELP : Yelp Inc.
YHOO : Yahoo! Inc.
YORW : The York Water Company
YRCW : YRC Worldwide, Inc.
YUME : YuMe, Inc.
YUM : Yum! Brands, Inc.
Y : Alleghany Corporation
ZAGG : ZAGG Inc
ZAZA : ZaZa Energy Corporation
ZBH : Untitled Dataset 2015-06-29 21:46:28
ZBRA : Zebra Technologies Corporation
ZEN : Zendesk, Inc.
ZEUS : Olympic Steel, Inc.
ZGNX : Zogenix, Inc.
ZINC : Horsehead Holding Corp.
ZION : Zions Bancorporation
ZIOP : ZIOPHARM Oncology Inc
ZIXI : Zix Corporation
ZLTQ : ZELTIQ Aesthetics, Inc.
ZNGA : Zynga Inc.
ZOES : Zoe's Kitchen, Inc.
ZQK : Quiksilver, Inc.
ZTS : Zoetis Inc.
ZUMZ : Zumiez Inc.
Z : Zillow, Inc.
